//MAP CONVERTED BY dmm2tgm.py THIS HEADER COMMENT PREVENTS RECONVERSION, DO NOT REMOVE
"a" = (
/turf/closed/mineral/random/low_chance_prison,
/area/f13/caves)
"b" = (
/turf/closed/indestructible/rock,
/area/f13/caves)

(1,1,1) = {"
a
a
a
a
a
a
a
a
a
"}
(2,1,1) = {"
a
a
a
a
a
a
a
a
a
"}
(3,1,1) = {"
a
a
a
a
a
a
a
a
a
"}
(4,1,1) = {"
a
a
b
b
b
a
a
a
a
"}
(5,1,1) = {"
a
a
a
b
b
b
b
a
a
"}
(6,1,1) = {"
a
a
a
a
a
b
b
b
a
"}
(7,1,1) = {"
a
a
a
a
a
a
a
a
a
"}
(8,1,1) = {"
a
a
a
a
a
a
a
a
a
"}
(9,1,1) = {"
a
a
a
a
a
a
a
a
a
"}
(10,1,1) = {"
a
a
a
a
a
a
a
a
a
"}
(11,1,1) = {"
a
a
a
b
b
a
a
a
a
"}
(12,1,1) = {"
a
a
a
b
b
b
a
a
a
"}
(13,1,1) = {"
a
a
b
b
b
b
a
a
a
"}
(14,1,1) = {"
a
a
b
b
b
a
a
b
a
"}
(15,1,1) = {"
a
a
a
b
a
a
b
b
a
"}
(16,1,1) = {"
a
a
a
a
a
b
b
a
a
"}
(17,1,1) = {"
a
a
a
a
a
b
a
a
a
"}
(18,1,1) = {"
a
a
a
a
a
a
a
a
a
"}
