//MAP CONVERTED BY dmm2tgm.py THIS HEADER COMMENT PREVENTS RECONVERSION, DO NOT REMOVE
"a" = (
/turf/closed/indestructible/rock,
/area/f13/caves)
"l" = (
/turf/closed/mineral/random/high_chance_prison,
/area/f13/caves)
"U" = (
/turf/closed/mineral/random/low_chance_prison,
/area/f13/caves)

(1,1,1) = {"
U
U
U
U
U
U
U
U
U
U
U
U
U
U
U
U
U
"}
(2,1,1) = {"
U
U
U
U
U
U
U
U
U
U
U
U
U
U
U
U
U
"}
(3,1,1) = {"
U
U
U
U
U
U
U
U
U
U
U
U
U
U
U
U
U
"}
(4,1,1) = {"
U
U
U
U
U
U
U
U
a
a
a
U
U
U
U
U
U
"}
(5,1,1) = {"
U
U
U
U
U
U
a
a
a
a
a
a
U
U
U
U
U
"}
(6,1,1) = {"
U
U
U
U
U
a
a
a
l
a
U
l
U
l
U
U
U
"}
(7,1,1) = {"
U
U
U
a
a
a
U
U
l
l
l
l
l
l
U
U
U
"}
(8,1,1) = {"
U
U
U
a
U
U
U
l
l
U
U
l
l
U
U
U
a
"}
(9,1,1) = {"
U
U
U
U
U
l
l
U
U
l
l
U
U
U
U
a
a
"}
(10,1,1) = {"
U
U
U
U
U
l
U
l
l
l
l
U
U
U
a
a
a
"}
(11,1,1) = {"
U
U
U
U
l
l
l
l
l
l
U
U
U
a
a
a
U
"}
(12,1,1) = {"
U
U
U
U
U
l
l
U
U
l
U
U
U
a
a
a
U
"}
(13,1,1) = {"
U
U
U
l
l
U
U
U
U
l
l
U
U
a
a
a
U
"}
(14,1,1) = {"
U
U
U
U
U
U
U
U
U
U
l
l
U
a
a
a
U
"}
(15,1,1) = {"
U
U
U
U
U
U
U
U
U
l
l
l
U
U
a
a
U
"}
(16,1,1) = {"
U
U
U
U
U
a
a
a
U
U
l
l
U
U
a
a
a
"}
(17,1,1) = {"
U
U
U
U
U
U
U
a
a
U
U
l
U
U
U
a
a
"}
(18,1,1) = {"
U
U
U
a
a
a
a
a
a
U
U
U
l
l
U
U
U
"}
(19,1,1) = {"
a
U
U
U
U
a
a
a
a
a
a
a
U
l
l
U
U
"}
(20,1,1) = {"
a
U
U
U
U
a
a
a
a
U
a
a
U
U
l
U
U
"}
(21,1,1) = {"
a
a
a
a
a
a
a
U
U
U
U
U
U
U
l
U
U
"}
(22,1,1) = {"
a
a
U
U
U
U
U
U
U
U
U
U
U
U
l
U
U
"}
(23,1,1) = {"
a
U
U
U
U
U
U
l
l
l
l
l
l
l
U
U
U
"}
(24,1,1) = {"
a
a
a
a
U
U
U
U
U
U
U
U
U
U
U
U
U
"}
(25,1,1) = {"
U
a
a
U
U
a
U
U
U
U
U
U
U
U
U
U
U
"}
