//MAP CONVERTED BY dmm2tgm.py THIS HEADER COMMENT PREVENTS RECONVERSION, DO NOT REMOVE
"a" = (
/turf/closed/mineral/random/low_chance_prison,
/area/f13/caves)
"x" = (
/turf/closed/mineral/random/high_chance_prison,
/area/f13/caves)
"G" = (
/turf/closed/indestructible/rock/smoothing,
/area/f13/caves)

(1,1,1) = {"
a
a
a
a
a
a
a
a
a
a
a
a
a
"}
(2,1,1) = {"
a
a
a
a
a
a
x
x
a
a
a
a
a
"}
(3,1,1) = {"
a
a
a
a
x
x
x
a
a
a
a
a
a
"}
(4,1,1) = {"
a
a
a
x
a
a
a
a
a
a
a
a
a
"}
(5,1,1) = {"
a
a
x
x
x
a
a
a
x
x
a
a
a
"}
(6,1,1) = {"
a
a
a
a
x
a
a
x
x
a
a
a
a
"}
(7,1,1) = {"
a
a
a
x
a
a
x
a
a
a
a
a
a
"}
(8,1,1) = {"
a
a
a
x
a
x
a
a
a
a
a
a
a
"}
(9,1,1) = {"
a
a
a
a
x
a
a
x
x
a
a
a
a
"}
(10,1,1) = {"
a
x
x
a
x
x
x
x
x
a
a
a
a
"}
(11,1,1) = {"
x
x
a
a
a
a
x
x
a
a
a
a
a
"}
(12,1,1) = {"
x
x
a
G
G
a
x
x
x
x
a
a
a
"}
(13,1,1) = {"
a
a
G
G
G
G
a
a
a
x
x
a
a
"}
(14,1,1) = {"
a
G
G
a
a
G
G
a
a
x
x
a
a
"}
(15,1,1) = {"
a
G
G
a
a
G
a
a
a
a
x
x
x
"}
(16,1,1) = {"
a
a
G
G
a
a
a
a
a
a
a
a
a
"}
