//MAP CONVERTED BY dmm2tgm.py THIS HEADER COMMENT PREVENTS RECONVERSION, DO NOT REMOVE
"a" = (
/turf/closed/mineral/random/high_chance_prison,
/area/f13/caves)
"h" = (
/turf/closed/indestructible/rock/smoothing,
/area/f13/caves)
"p" = (
/turf/closed/mineral/random/low_chance_prison,
/area/f13/caves)
"U" = (
/obj/item/toy/beach_ball/holoball,
/turf/open/indestructible/ground/inside/mountain,
/area/f13/caves)
"Z" = (
/turf/open/indestructible/ground/inside/mountain,
/area/f13/caves)

(1,1,1) = {"
p
p
p
p
p
p
p
p
p
"}
(2,1,1) = {"
p
a
p
a
a
p
p
p
p
"}
(3,1,1) = {"
p
a
a
a
p
p
p
h
h
"}
(4,1,1) = {"
p
a
a
p
p
h
h
h
h
"}
(5,1,1) = {"
p
p
p
h
h
h
h
h
h
"}
(6,1,1) = {"
p
p
h
h
h
h
h
h
p
"}
(7,1,1) = {"
h
h
h
h
p
h
h
h
p
"}
(8,1,1) = {"
p
p
p
p
p
p
p
p
p
"}
(9,1,1) = {"
p
p
p
a
p
a
a
a
p
"}
(10,1,1) = {"
p
p
a
a
a
p
p
p
p
"}
(11,1,1) = {"
p
a
a
a
p
p
p
h
p
"}
(12,1,1) = {"
a
a
p
p
p
h
h
h
p
"}
(13,1,1) = {"
p
p
p
p
h
h
h
p
p
"}
(14,1,1) = {"
p
a
p
p
h
h
p
p
p
"}
(15,1,1) = {"
a
a
p
p
p
p
p
a
a
"}
(16,1,1) = {"
p
p
p
h
h
h
p
p
a
"}
(17,1,1) = {"
p
p
h
h
h
h
h
p
p
"}
(18,1,1) = {"
h
p
p
h
Z
h
h
h
p
"}
(19,1,1) = {"
h
h
p
h
Z
Z
h
h
a
"}
(20,1,1) = {"
h
h
Z
h
U
Z
h
h
a
"}
(21,1,1) = {"
h
h
Z
Z
Z
h
h
h
a
"}
(22,1,1) = {"
h
h
Z
Z
Z
h
h
a
a
"}
(23,1,1) = {"
h
h
p
Z
h
h
h
a
h
"}
(24,1,1) = {"
h
h
p
h
h
h
p
a
h
"}
(25,1,1) = {"
h
h
p
p
p
p
p
p
h
"}
(26,1,1) = {"
h
h
p
a
a
a
p
h
h
"}
(27,1,1) = {"
h
p
p
p
a
a
p
h
h
"}
(28,1,1) = {"
h
p
p
p
a
p
p
h
h
"}
(29,1,1) = {"
h
p
p
a
p
p
p
h
h
"}
(30,1,1) = {"
h
h
p
a
p
p
p
h
h
"}
(31,1,1) = {"
h
h
p
a
a
p
h
h
h
"}
(32,1,1) = {"
h
h
p
a
a
p
h
h
h
"}
(33,1,1) = {"
h
h
p
a
p
p
h
h
h
"}
(34,1,1) = {"
h
h
p
p
p
p
p
h
p
"}
