//MAP CONVERTED BY dmm2tgm.py THIS HEADER COMMENT PREVENTS RECONVERSION, DO NOT REMOVE
"a" = (
/turf/open/indestructible/ground/outside/saltflats{
	icon = 'icons/turf/snow.dmi';
	icon_state = "snow";
	barefootstep = "gravel";
	clawfootstep = "gravel";
	footstep = "gravel"
	},
/area/space)

(1,1,1) = {"
a
"}
