//MAP CONVERTED BY dmm2tgm.py THIS HEADER COMMENT PREVENTS RECONVERSION, DO NOT REMOVE
"heT" = (
/obj/effect/landmark/map_load_mark/dungeons/ghoulsubway,
/turf/closed/mineral/random/low_chance,
/area/f13/reno_caves)
"ofT" = (
/turf/closed/mineral/random/low_chance,
/area/f13/reno_caves)
"ulp" = (
/turf/closed/indestructible/paper,
/area/space)
"xPE" = (
/obj/effect/landmark/map_load_mark/dungeons/raidersubway,
/turf/closed/mineral/random/low_chance,
/area/f13/reno_caves)

(1,1,1) = {"
ofT
ofT
ofT
ofT
ofT
ofT
ofT
ofT
ofT
ofT
ofT
ofT
ofT
ofT
ofT
ofT
ofT
ofT
ofT
ofT
ofT
ofT
ofT
ofT
ofT
ofT
ofT
ofT
ofT
ofT
ofT
ofT
ofT
ofT
ofT
ofT
ofT
ofT
ofT
ofT
ofT
ofT
ofT
ofT
ofT
ofT
ofT
ofT
ofT
ofT
ofT
ofT
xPE
"}
(2,1,1) = {"
ofT
ofT
ofT
ofT
ofT
ofT
ofT
ofT
ofT
ofT
ofT
ofT
ofT
ofT
ofT
ofT
ofT
ofT
ofT
ofT
ofT
ofT
ofT
ofT
ofT
ofT
ofT
ofT
ofT
ofT
ofT
ofT
ofT
ofT
ofT
ofT
ofT
ofT
ofT
ofT
ofT
ofT
ofT
ofT
ofT
ofT
ofT
ofT
ofT
ofT
ofT
ofT
ofT
"}
(3,1,1) = {"
ofT
ofT
ofT
ofT
ofT
ofT
ofT
ofT
ofT
ofT
ofT
ofT
ofT
ofT
ofT
ofT
ofT
ofT
ofT
ofT
ofT
ofT
ofT
ofT
ofT
ofT
ofT
ofT
ofT
ofT
ofT
ofT
ofT
ofT
ofT
ofT
ofT
ofT
ofT
ofT
ofT
ofT
ofT
ofT
ofT
ofT
ofT
ofT
ofT
ofT
ofT
ofT
ofT
"}
(4,1,1) = {"
ofT
ofT
ofT
ofT
ofT
ofT
ofT
ofT
ofT
ofT
ofT
ofT
ofT
ofT
ofT
ofT
ofT
ofT
ofT
ofT
ofT
ofT
ofT
ofT
ofT
ofT
ofT
ofT
ofT
ofT
ofT
ofT
ofT
ofT
ofT
ofT
ofT
ofT
ofT
ofT
ofT
ofT
ofT
ofT
ofT
ofT
ofT
ofT
ofT
ofT
ofT
ofT
ofT
"}
(5,1,1) = {"
ofT
ofT
ofT
ofT
ofT
ofT
ofT
ofT
ofT
ofT
ofT
ofT
ofT
ofT
ofT
ofT
ofT
ofT
ofT
ofT
ofT
ofT
ofT
ofT
ofT
ofT
ofT
ofT
ofT
ofT
ofT
ofT
ofT
ofT
ofT
ofT
ofT
ofT
ofT
ofT
ofT
ofT
ofT
ofT
ofT
ofT
ofT
ofT
ofT
ofT
ofT
ofT
ofT
"}
(6,1,1) = {"
ofT
ofT
ofT
ofT
ofT
ofT
ofT
ofT
ofT
ofT
ofT
ofT
ofT
ofT
ofT
ofT
ofT
ofT
ofT
ofT
ofT
ofT
ofT
ofT
ofT
ofT
ofT
ofT
ofT
ofT
ofT
ofT
ofT
ofT
ofT
ofT
ofT
ofT
ofT
ofT
ofT
ofT
ofT
ofT
ofT
ofT
ofT
ofT
ofT
ofT
ofT
ofT
ofT
"}
(7,1,1) = {"
ofT
ofT
ofT
ofT
ofT
ofT
ofT
ofT
ofT
ofT
ofT
ofT
ofT
ofT
ofT
ofT
ofT
ofT
ofT
ofT
ofT
ofT
ofT
ofT
ofT
ofT
ofT
ofT
ofT
ofT
ofT
ofT
ofT
ofT
ofT
ofT
ofT
ofT
ofT
ofT
ofT
ofT
ofT
ofT
ofT
ofT
ofT
ofT
ofT
ofT
ofT
ofT
ofT
"}
(8,1,1) = {"
ofT
ofT
ofT
ofT
ofT
ofT
ofT
ofT
ofT
ofT
ofT
ofT
ofT
ofT
ofT
ofT
ofT
ofT
ofT
ofT
ofT
ofT
ofT
ofT
ofT
ofT
ofT
ofT
ofT
ofT
ofT
ofT
ofT
ofT
ofT
ofT
ofT
ofT
ofT
ofT
ofT
ofT
ofT
ofT
ofT
ofT
ofT
ofT
ofT
ofT
ofT
ofT
ofT
"}
(9,1,1) = {"
ofT
ofT
ofT
ofT
ofT
ofT
ofT
ofT
ofT
ofT
ofT
ofT
ofT
ofT
ofT
ofT
ofT
ofT
ofT
ofT
ofT
ofT
ofT
ofT
ofT
ofT
ofT
ofT
ofT
ofT
ofT
ofT
ofT
ofT
ofT
ofT
ofT
ofT
ofT
ofT
ofT
ofT
ofT
ofT
ofT
ofT
ofT
ofT
ofT
ofT
ofT
ofT
ofT
"}
(10,1,1) = {"
ofT
ofT
ofT
ofT
ofT
ofT
ofT
ofT
ofT
ofT
ofT
ofT
ofT
ofT
ofT
ofT
ofT
ofT
ofT
ofT
ofT
ofT
ofT
ofT
ofT
ofT
ofT
ofT
ofT
ofT
ofT
ofT
ofT
ofT
ofT
ofT
ofT
ofT
ofT
ofT
ofT
ofT
ofT
ofT
ofT
ofT
ofT
ofT
ofT
ofT
ofT
ofT
ofT
"}
(11,1,1) = {"
ofT
ofT
ofT
ofT
ofT
ofT
ofT
ofT
ofT
ofT
ofT
ofT
ofT
ofT
ofT
ofT
ofT
ofT
ofT
ofT
ofT
ofT
ofT
ofT
ofT
ofT
ofT
ofT
ofT
ofT
ofT
ofT
ofT
ofT
ofT
ofT
ofT
ofT
ofT
ofT
ofT
ofT
ofT
ofT
ofT
ofT
ofT
ofT
ofT
ofT
ofT
ofT
ofT
"}
(12,1,1) = {"
ofT
ofT
ofT
ofT
ofT
ofT
ofT
ofT
ofT
ofT
ofT
ofT
ofT
ofT
ofT
ofT
ofT
ofT
ofT
ofT
ofT
ofT
ofT
ofT
ofT
ofT
ofT
ofT
ofT
ofT
ofT
ofT
ofT
ofT
ofT
ofT
ofT
ofT
ofT
ofT
ofT
ofT
ofT
ofT
ofT
ofT
ofT
ofT
ofT
ofT
ofT
ofT
ofT
"}
(13,1,1) = {"
ofT
ofT
ofT
ofT
ofT
ofT
ofT
ofT
ofT
ofT
ofT
ofT
ofT
ofT
ofT
ofT
ofT
ofT
ofT
ofT
ofT
ofT
ofT
ofT
ofT
ofT
ofT
ofT
ofT
ofT
ofT
ofT
ofT
ofT
ofT
ofT
ofT
ofT
ofT
ofT
ofT
ofT
ofT
ofT
ofT
ofT
ofT
ofT
ofT
ofT
ofT
ofT
ofT
"}
(14,1,1) = {"
ofT
ofT
ofT
ofT
ofT
ofT
ofT
ofT
ofT
ofT
ofT
ofT
ofT
ofT
ofT
ofT
ofT
ofT
ofT
ofT
ofT
ofT
ofT
ofT
ofT
ofT
ofT
ofT
ofT
ofT
ofT
ofT
ofT
ofT
ofT
ofT
ofT
ofT
ofT
ofT
ofT
ofT
ofT
ofT
ofT
ofT
ofT
ofT
ofT
ofT
ofT
ofT
ofT
"}
(15,1,1) = {"
ofT
ofT
ofT
ofT
ofT
ofT
ofT
ofT
ofT
ofT
ofT
ofT
ofT
ofT
ofT
ofT
ofT
ofT
ofT
ofT
ofT
ofT
ofT
ofT
ofT
ofT
ofT
ofT
ofT
ofT
ofT
ofT
ofT
ofT
ofT
ofT
ofT
ofT
ofT
ofT
ofT
ofT
ofT
ofT
ofT
ofT
ofT
ofT
ofT
ofT
ofT
ofT
ofT
"}
(16,1,1) = {"
ofT
ofT
ofT
ofT
ofT
ofT
ofT
ofT
ofT
ofT
ofT
ofT
ofT
ofT
ofT
ofT
ofT
ofT
ofT
ofT
ofT
ofT
ofT
ofT
ofT
ofT
ofT
ofT
ofT
ofT
ofT
ofT
ofT
ofT
ofT
ofT
ofT
ofT
ofT
ofT
ofT
ofT
ofT
ofT
ofT
ofT
ofT
ofT
ofT
ofT
ofT
ofT
ofT
"}
(17,1,1) = {"
ofT
ofT
ofT
ofT
ofT
ofT
ofT
ofT
ofT
ofT
ofT
ofT
ofT
ofT
ofT
ofT
ofT
ofT
ofT
ofT
ofT
ofT
ofT
ofT
ofT
ofT
ofT
ofT
ofT
ofT
ofT
ofT
ofT
ofT
ofT
ofT
ofT
ofT
ofT
ofT
ofT
ofT
ofT
ofT
ofT
ofT
ofT
ofT
ofT
ofT
ofT
ofT
ofT
"}
(18,1,1) = {"
ofT
ofT
ofT
ofT
ofT
ofT
ofT
ofT
ofT
ofT
ofT
ofT
ofT
ofT
ofT
ofT
ofT
ofT
ofT
ofT
ofT
ofT
ofT
ofT
ofT
ofT
ofT
ofT
ofT
ofT
ofT
ofT
ofT
ofT
ofT
ofT
ofT
ofT
ofT
ofT
ofT
ofT
ofT
ofT
ofT
ofT
ofT
ofT
ofT
ofT
ofT
ofT
ofT
"}
(19,1,1) = {"
ofT
ofT
ofT
ofT
ofT
ofT
ofT
ofT
ofT
ofT
ofT
ofT
ofT
ofT
ofT
ofT
ofT
ofT
ofT
ofT
ofT
ofT
ofT
ofT
ofT
ofT
ofT
ofT
ofT
ofT
ofT
ofT
ofT
ofT
ofT
ofT
ofT
ofT
ofT
ofT
ofT
ofT
ofT
ofT
ofT
ofT
ofT
ofT
ofT
ofT
ofT
ofT
ofT
"}
(20,1,1) = {"
ofT
ofT
ofT
ofT
ofT
ofT
ofT
ofT
ofT
ofT
ofT
ofT
ofT
ofT
ofT
ofT
ofT
ofT
ofT
ofT
ofT
ofT
ofT
ofT
ofT
ofT
ofT
ofT
ofT
ofT
ofT
ofT
ofT
ofT
ofT
ofT
ofT
ofT
ofT
ofT
ofT
ofT
ofT
ofT
ofT
ofT
ofT
ofT
ofT
ofT
ofT
ofT
ofT
"}
(21,1,1) = {"
ofT
ofT
ofT
ofT
ofT
ofT
ofT
ofT
ofT
ofT
ofT
ofT
ofT
ofT
ofT
ofT
ofT
ofT
ofT
ofT
ofT
ofT
ofT
ofT
ofT
ofT
ofT
ofT
ofT
ofT
ofT
ofT
ofT
ofT
ofT
ofT
ofT
ofT
ofT
ofT
ofT
ofT
ofT
ofT
ofT
ofT
ofT
ofT
ofT
ofT
ofT
ofT
ofT
"}
(22,1,1) = {"
ofT
ofT
ofT
ofT
ofT
ofT
ofT
ofT
ofT
ofT
ofT
ofT
ofT
ofT
ofT
ofT
ofT
ofT
ofT
ofT
ofT
ofT
ofT
ofT
ofT
ofT
ofT
ofT
ofT
ofT
ofT
ofT
ofT
ofT
ofT
ofT
ofT
ofT
ofT
ofT
ofT
ofT
ofT
ofT
ofT
ofT
ofT
ofT
ofT
ofT
ofT
ofT
ofT
"}
(23,1,1) = {"
ofT
ofT
ofT
ofT
ofT
ofT
ofT
ofT
ofT
ofT
ofT
ofT
ofT
ofT
ofT
ofT
ofT
ofT
ofT
ofT
ofT
ofT
ofT
ofT
ofT
ofT
ofT
ofT
ofT
ofT
ofT
ofT
ofT
ofT
ofT
ofT
ofT
ofT
ofT
ofT
ofT
ofT
ofT
ofT
ofT
ofT
ofT
ofT
ofT
ofT
ofT
ofT
ofT
"}
(24,1,1) = {"
ofT
ofT
ofT
ofT
ofT
ofT
ofT
ofT
ofT
ofT
ofT
ofT
ofT
ofT
ofT
ofT
ofT
ofT
ofT
ofT
ofT
ofT
ofT
ofT
ofT
ofT
ofT
ofT
ofT
ofT
ofT
ofT
ofT
ofT
ofT
ofT
ofT
ofT
ofT
ofT
ofT
ofT
ofT
ofT
ofT
ofT
ofT
ofT
ofT
ofT
ofT
ofT
ofT
"}
(25,1,1) = {"
ofT
ofT
ofT
ofT
ofT
ofT
ofT
ofT
ofT
ofT
ofT
ofT
ofT
ofT
ofT
ofT
ofT
ofT
ofT
ofT
ofT
ofT
ofT
ofT
ofT
ofT
ofT
ofT
ofT
ofT
ofT
ofT
ofT
ofT
ofT
ofT
ofT
ofT
ofT
ofT
ofT
ofT
ofT
ofT
ofT
ofT
ofT
ofT
ofT
ofT
ofT
ofT
ofT
"}
(26,1,1) = {"
ofT
ofT
ofT
ofT
ofT
ofT
ofT
ofT
ofT
ofT
ofT
ofT
ofT
ofT
ofT
ofT
ofT
ofT
ofT
ofT
ofT
ofT
ofT
ofT
ofT
ofT
ofT
ofT
ofT
ofT
ofT
ofT
ofT
ofT
ofT
ofT
ofT
ofT
ofT
ofT
ofT
ofT
ofT
ofT
ofT
ofT
ofT
ofT
ofT
ofT
ofT
ofT
ofT
"}
(27,1,1) = {"
ofT
ofT
ofT
ofT
ofT
ofT
ofT
ofT
ofT
ofT
ofT
ofT
ofT
ofT
ofT
ofT
ofT
ofT
ofT
ofT
ofT
ofT
ofT
ofT
ofT
ofT
ofT
ofT
ofT
ofT
ofT
ofT
ofT
ofT
ofT
ofT
ofT
ofT
ofT
ofT
ofT
ofT
ofT
ofT
ofT
ofT
ofT
ofT
ofT
ofT
ofT
ofT
ofT
"}
(28,1,1) = {"
ofT
ofT
ofT
ofT
ofT
ofT
ofT
ofT
ofT
ofT
ofT
ofT
ofT
ofT
ofT
ofT
ofT
ofT
ofT
ofT
ofT
ofT
ofT
ofT
ofT
ofT
ofT
ofT
ofT
ofT
ofT
ofT
ofT
ofT
ofT
ofT
ofT
ofT
ofT
ofT
ofT
ofT
ofT
ofT
ofT
ofT
ofT
ofT
ofT
ofT
ofT
ofT
ofT
"}
(29,1,1) = {"
ofT
ofT
ofT
ofT
ofT
ofT
ofT
ofT
ofT
ofT
ofT
ofT
ofT
ofT
ofT
ofT
ofT
ofT
ofT
ofT
ofT
ofT
ofT
ofT
ofT
ofT
ofT
ofT
ofT
ofT
ofT
ofT
ofT
ofT
ofT
ofT
ofT
ofT
ofT
ofT
ofT
ofT
ofT
ofT
ofT
ofT
ofT
ofT
ofT
ofT
ofT
ofT
ofT
"}
(30,1,1) = {"
ofT
ofT
ofT
ofT
ofT
ofT
ofT
ofT
ofT
ofT
ofT
ofT
ofT
ofT
ofT
ofT
ofT
ofT
ofT
ofT
ofT
ofT
ofT
ofT
ofT
ofT
ofT
ofT
ofT
ofT
ofT
ofT
ofT
ofT
ofT
ofT
ofT
ofT
ofT
ofT
ofT
ofT
ofT
ofT
ofT
ofT
ofT
ofT
ofT
ofT
ofT
ofT
ofT
"}
(31,1,1) = {"
ofT
ofT
ofT
ofT
ofT
ofT
ofT
ofT
ofT
ofT
ofT
ofT
ofT
ofT
ofT
ofT
ofT
ofT
ofT
ofT
ofT
ofT
ofT
ofT
ofT
ofT
ofT
ofT
ofT
ofT
ofT
ofT
ofT
ofT
ofT
ofT
ofT
ofT
ofT
ofT
ofT
ofT
ofT
ofT
ofT
ofT
ofT
ofT
ofT
ofT
ofT
ofT
ofT
"}
(32,1,1) = {"
ofT
ofT
ofT
ofT
ofT
ofT
ofT
ofT
ofT
ofT
ofT
ofT
ofT
ofT
ofT
ofT
ofT
ofT
ofT
ofT
ofT
ofT
ofT
ofT
ofT
ofT
ofT
ofT
ofT
ofT
ofT
ofT
ofT
ofT
ofT
ofT
ofT
ofT
ofT
ofT
ofT
ofT
ofT
ofT
ofT
ofT
ofT
ofT
ofT
ofT
ofT
ofT
ofT
"}
(33,1,1) = {"
ofT
ofT
ofT
ofT
ofT
ofT
ofT
ofT
ofT
ofT
ofT
ofT
ofT
ofT
ofT
ofT
ofT
ofT
ofT
ofT
ofT
ofT
ofT
ofT
ofT
ofT
ofT
ofT
ofT
ofT
ofT
ofT
ofT
ofT
ofT
ofT
ofT
ofT
ofT
ofT
ofT
ofT
ofT
ofT
ofT
ofT
ofT
ofT
ofT
ofT
ofT
ofT
ofT
"}
(34,1,1) = {"
ofT
ofT
ofT
ofT
ofT
ofT
ofT
ofT
ofT
ofT
ofT
ofT
ofT
ofT
ofT
ofT
ofT
ofT
ofT
ofT
ofT
ofT
ofT
ofT
ofT
ofT
ofT
ofT
ofT
ofT
ofT
ofT
ofT
ofT
ofT
ofT
ofT
ofT
ofT
ofT
ofT
ofT
ofT
ofT
ofT
ofT
ofT
ofT
ofT
ofT
ofT
ofT
ofT
"}
(35,1,1) = {"
ofT
ofT
ofT
ofT
ofT
ofT
ofT
ofT
ofT
ofT
ofT
ofT
ofT
ofT
ofT
ofT
ofT
ofT
ofT
ofT
ofT
ofT
ofT
ofT
ofT
ofT
ofT
ofT
ofT
ofT
ofT
ofT
ofT
ofT
ofT
ofT
ofT
ofT
ofT
ofT
ofT
ofT
ofT
ofT
ofT
ofT
ofT
ofT
ofT
ofT
ofT
ofT
ofT
"}
(36,1,1) = {"
ofT
ofT
ofT
ofT
ofT
ofT
ofT
ofT
ofT
ofT
ofT
ofT
ofT
ofT
ofT
ofT
ofT
ofT
ofT
ofT
ofT
ofT
ofT
ofT
ofT
ofT
ofT
ofT
ofT
ofT
ofT
ofT
ofT
ofT
ofT
ofT
ofT
ofT
ofT
ofT
ofT
ofT
ofT
ofT
ofT
ofT
ofT
ofT
ofT
ofT
ofT
ofT
ofT
"}
(37,1,1) = {"
ofT
ofT
ofT
ofT
ofT
ofT
ofT
ofT
ofT
ofT
ofT
ofT
ofT
ofT
ofT
ofT
ofT
ofT
ofT
ofT
ofT
ofT
ofT
ofT
ofT
ofT
ofT
ofT
ofT
ofT
ofT
ofT
ofT
ofT
ofT
ofT
ofT
ofT
ofT
ofT
ofT
ofT
ofT
ofT
ofT
ofT
ofT
ofT
ofT
ofT
ofT
ofT
ofT
"}
(38,1,1) = {"
ofT
ofT
ofT
ofT
ofT
ofT
ofT
ofT
ofT
ofT
ofT
ofT
ofT
ofT
ofT
ofT
ofT
ofT
ofT
ofT
ofT
ofT
ofT
ofT
ofT
ofT
ofT
ofT
ofT
ofT
ofT
ofT
ofT
ofT
ofT
ofT
ofT
ofT
ofT
ofT
ofT
ofT
ofT
ofT
ofT
ofT
ofT
ofT
ofT
ofT
ofT
ofT
ofT
"}
(39,1,1) = {"
ofT
ofT
ofT
ofT
ofT
ofT
ofT
ofT
ofT
ofT
ofT
ofT
ofT
ofT
ofT
ofT
ofT
ofT
ofT
ofT
ofT
ofT
ofT
ofT
ofT
ofT
ofT
ofT
ofT
ofT
ofT
ofT
ofT
ofT
ofT
ofT
ofT
ofT
ofT
ofT
ofT
ofT
ofT
ofT
ofT
ofT
ofT
ofT
ofT
ofT
ofT
ofT
ofT
"}
(40,1,1) = {"
ofT
ofT
ofT
ofT
ofT
ofT
ofT
ofT
ofT
ofT
ofT
ofT
ofT
ofT
ofT
ofT
ofT
ofT
ofT
ofT
ofT
ofT
ofT
ofT
ofT
ofT
ofT
ofT
ofT
ofT
ofT
ofT
ofT
ofT
ofT
ofT
ofT
ofT
ofT
ofT
ofT
ofT
ofT
ofT
ofT
ofT
ofT
ofT
ofT
ofT
ofT
ofT
ofT
"}
(41,1,1) = {"
ofT
ofT
ofT
ofT
ofT
ofT
ofT
ofT
ofT
ofT
ofT
ofT
ofT
ofT
ofT
ofT
ofT
ofT
ofT
ofT
ofT
ofT
ofT
ofT
ofT
ofT
ofT
ofT
ofT
ofT
ofT
ofT
ofT
ofT
ofT
ofT
ofT
ofT
ofT
ofT
ofT
ofT
ofT
ofT
ofT
ofT
ofT
ofT
ofT
ofT
ofT
ofT
ofT
"}
(42,1,1) = {"
ofT
ofT
ofT
ofT
ofT
ofT
ofT
ofT
ofT
ofT
ofT
ofT
ofT
ofT
ofT
ofT
ofT
ofT
ofT
ofT
ofT
ofT
ofT
ofT
ofT
ofT
ofT
ofT
ofT
ofT
ofT
ofT
ofT
ofT
ofT
ofT
ofT
ofT
ofT
ofT
ofT
ofT
ofT
ofT
ofT
ofT
ofT
ofT
ofT
ofT
ofT
ofT
ofT
"}
(43,1,1) = {"
ofT
ofT
ofT
ofT
ofT
ofT
ofT
ofT
ofT
ofT
ofT
ofT
ofT
ofT
ofT
ofT
ofT
ofT
ofT
ofT
ofT
ofT
ofT
ofT
ofT
ofT
ofT
ofT
ofT
ofT
ofT
ofT
ofT
ofT
ofT
ofT
ofT
ofT
ofT
ofT
ofT
ofT
ofT
ofT
ofT
ofT
ofT
ofT
ofT
ofT
ofT
ofT
ofT
"}
(44,1,1) = {"
ofT
ofT
ofT
ofT
ofT
ofT
ofT
ofT
ofT
ofT
ofT
ofT
ofT
ofT
ofT
ofT
ofT
ofT
ofT
ofT
ofT
ofT
ofT
ofT
ofT
ofT
ofT
ofT
ofT
ofT
ofT
ofT
ofT
ofT
ofT
ofT
ofT
ofT
ofT
ofT
ofT
ofT
ofT
ofT
ofT
ofT
ofT
ofT
ofT
ofT
ofT
ofT
ofT
"}
(45,1,1) = {"
ofT
ofT
ofT
ofT
ofT
ofT
ofT
ofT
ofT
ofT
ofT
ofT
ofT
ofT
ofT
ofT
ofT
ofT
ofT
ofT
ofT
ofT
ofT
ofT
ofT
ofT
ofT
ofT
ofT
ofT
ofT
ofT
ofT
ofT
ofT
ofT
ofT
ofT
ofT
ofT
ofT
ofT
ofT
ofT
ofT
ofT
ofT
ofT
ofT
ofT
ofT
ofT
ofT
"}
(46,1,1) = {"
ofT
ofT
ofT
ofT
ofT
ofT
ofT
ofT
ofT
ofT
ofT
ofT
ofT
ofT
ofT
ofT
ofT
ofT
ofT
ofT
ofT
ofT
ofT
ofT
ofT
ofT
ofT
ofT
ofT
ofT
ofT
ofT
ofT
ofT
ofT
ofT
ofT
ofT
ofT
ofT
ofT
ofT
ofT
ofT
ofT
ofT
ofT
ofT
ofT
ofT
ofT
ofT
ofT
"}
(47,1,1) = {"
ofT
ofT
ofT
ofT
ofT
ofT
ofT
ofT
ofT
ofT
ofT
ofT
ofT
ofT
ofT
ofT
ofT
ofT
ofT
ofT
ofT
ofT
ofT
ofT
ofT
ofT
ofT
ofT
ofT
ofT
ofT
ofT
ofT
ofT
ofT
ofT
ofT
ofT
ofT
ofT
ofT
ofT
ofT
ofT
ofT
ofT
ofT
ofT
ofT
ofT
ofT
ofT
ofT
"}
(48,1,1) = {"
ofT
ofT
ofT
ofT
ofT
ofT
ofT
ofT
ofT
ofT
ofT
ofT
ofT
ofT
ofT
ofT
ofT
ofT
ofT
ofT
ofT
ofT
ofT
ofT
ofT
ofT
ofT
ofT
ofT
ofT
ofT
ofT
ofT
ofT
ofT
ofT
ofT
ofT
ofT
ofT
ofT
ofT
ofT
ofT
ofT
ofT
ofT
ofT
ofT
ofT
ofT
ofT
ofT
"}
(49,1,1) = {"
ofT
ofT
ofT
ofT
ofT
ofT
ofT
ofT
ofT
ofT
ofT
ofT
ofT
ofT
ofT
ofT
ofT
ofT
ofT
ofT
ofT
ofT
ofT
ofT
ofT
ofT
ofT
ofT
ofT
ofT
ofT
ofT
ofT
ofT
ofT
ofT
ofT
ofT
ofT
ofT
ofT
ofT
ofT
ofT
ofT
ofT
ofT
ofT
ofT
ofT
ofT
ofT
ofT
"}
(50,1,1) = {"
ofT
ofT
ofT
ofT
ofT
ofT
ofT
ofT
ofT
ofT
ofT
ofT
ofT
ofT
ofT
ofT
ofT
ofT
ofT
ofT
ofT
ofT
ofT
ofT
ofT
ofT
ofT
ofT
ofT
ofT
ofT
ofT
ofT
ofT
ofT
ofT
ofT
ofT
ofT
ofT
ofT
ofT
ofT
ofT
ofT
ofT
ofT
ofT
ofT
ofT
ofT
ofT
ofT
"}
(51,1,1) = {"
ofT
ofT
ofT
ofT
ofT
ofT
ofT
ofT
ofT
ofT
ofT
ofT
ofT
ofT
ofT
ofT
ofT
ofT
ofT
ofT
ofT
ofT
ofT
ofT
ofT
ofT
ofT
ofT
ofT
ofT
ofT
ofT
ofT
ofT
ofT
ofT
ofT
ofT
ofT
ofT
ofT
ofT
ofT
ofT
ofT
ofT
ofT
ofT
ofT
ofT
ofT
ofT
ofT
"}
(52,1,1) = {"
ofT
ofT
ofT
ofT
ofT
ofT
ofT
ofT
ofT
ofT
ofT
ofT
ofT
ofT
ofT
ofT
ofT
ofT
ofT
ofT
ofT
ofT
ofT
ofT
ofT
ofT
ofT
ofT
ofT
ofT
ofT
ofT
ofT
ofT
ofT
ofT
ofT
ofT
ofT
ofT
ofT
ofT
ofT
ofT
ofT
ofT
ofT
ofT
ofT
ofT
ofT
ofT
ofT
"}
(53,1,1) = {"
ofT
ofT
ofT
ofT
ofT
ofT
ofT
ofT
ofT
ofT
ofT
ofT
ofT
ofT
ofT
ofT
ofT
ofT
ofT
ofT
ofT
ofT
ofT
ofT
ofT
ofT
ofT
ofT
ofT
ofT
ofT
ofT
ofT
ofT
ofT
ofT
ofT
ofT
ofT
ofT
ofT
ofT
ofT
ofT
ofT
ofT
ofT
ofT
ofT
ofT
ofT
ofT
ofT
"}
(54,1,1) = {"
ulp
ulp
ulp
ulp
ulp
ulp
ulp
ulp
ulp
ulp
ulp
ulp
ulp
ulp
ulp
ulp
ulp
ulp
ulp
ulp
ulp
ulp
ulp
ulp
ulp
ulp
ulp
ulp
ulp
ulp
ulp
ulp
ulp
ulp
ulp
ulp
ulp
ulp
ulp
ulp
ulp
ulp
ulp
ulp
ulp
ulp
ulp
ulp
ulp
ulp
ulp
ulp
ulp
"}
(55,1,1) = {"
ofT
ofT
ofT
ofT
ofT
ofT
ofT
ofT
ofT
ofT
ofT
ofT
ofT
ofT
ofT
ofT
ofT
ofT
ofT
ofT
ofT
ofT
ofT
ofT
ofT
ofT
ofT
ofT
ofT
ofT
ofT
ofT
ofT
ofT
ofT
ofT
ofT
ofT
ofT
ofT
ofT
ofT
ofT
ofT
ofT
ofT
ofT
ofT
ofT
ofT
ofT
ofT
heT
"}
(56,1,1) = {"
ofT
ofT
ofT
ofT
ofT
ofT
ofT
ofT
ofT
ofT
ofT
ofT
ofT
ofT
ofT
ofT
ofT
ofT
ofT
ofT
ofT
ofT
ofT
ofT
ofT
ofT
ofT
ofT
ofT
ofT
ofT
ofT
ofT
ofT
ofT
ofT
ofT
ofT
ofT
ofT
ofT
ofT
ofT
ofT
ofT
ofT
ofT
ofT
ofT
ofT
ofT
ofT
ofT
"}
(57,1,1) = {"
ofT
ofT
ofT
ofT
ofT
ofT
ofT
ofT
ofT
ofT
ofT
ofT
ofT
ofT
ofT
ofT
ofT
ofT
ofT
ofT
ofT
ofT
ofT
ofT
ofT
ofT
ofT
ofT
ofT
ofT
ofT
ofT
ofT
ofT
ofT
ofT
ofT
ofT
ofT
ofT
ofT
ofT
ofT
ofT
ofT
ofT
ofT
ofT
ofT
ofT
ofT
ofT
ofT
"}
(58,1,1) = {"
ofT
ofT
ofT
ofT
ofT
ofT
ofT
ofT
ofT
ofT
ofT
ofT
ofT
ofT
ofT
ofT
ofT
ofT
ofT
ofT
ofT
ofT
ofT
ofT
ofT
ofT
ofT
ofT
ofT
ofT
ofT
ofT
ofT
ofT
ofT
ofT
ofT
ofT
ofT
ofT
ofT
ofT
ofT
ofT
ofT
ofT
ofT
ofT
ofT
ofT
ofT
ofT
ofT
"}
(59,1,1) = {"
ofT
ofT
ofT
ofT
ofT
ofT
ofT
ofT
ofT
ofT
ofT
ofT
ofT
ofT
ofT
ofT
ofT
ofT
ofT
ofT
ofT
ofT
ofT
ofT
ofT
ofT
ofT
ofT
ofT
ofT
ofT
ofT
ofT
ofT
ofT
ofT
ofT
ofT
ofT
ofT
ofT
ofT
ofT
ofT
ofT
ofT
ofT
ofT
ofT
ofT
ofT
ofT
ofT
"}
(60,1,1) = {"
ofT
ofT
ofT
ofT
ofT
ofT
ofT
ofT
ofT
ofT
ofT
ofT
ofT
ofT
ofT
ofT
ofT
ofT
ofT
ofT
ofT
ofT
ofT
ofT
ofT
ofT
ofT
ofT
ofT
ofT
ofT
ofT
ofT
ofT
ofT
ofT
ofT
ofT
ofT
ofT
ofT
ofT
ofT
ofT
ofT
ofT
ofT
ofT
ofT
ofT
ofT
ofT
ofT
"}
(61,1,1) = {"
ofT
ofT
ofT
ofT
ofT
ofT
ofT
ofT
ofT
ofT
ofT
ofT
ofT
ofT
ofT
ofT
ofT
ofT
ofT
ofT
ofT
ofT
ofT
ofT
ofT
ofT
ofT
ofT
ofT
ofT
ofT
ofT
ofT
ofT
ofT
ofT
ofT
ofT
ofT
ofT
ofT
ofT
ofT
ofT
ofT
ofT
ofT
ofT
ofT
ofT
ofT
ofT
ofT
"}
(62,1,1) = {"
ofT
ofT
ofT
ofT
ofT
ofT
ofT
ofT
ofT
ofT
ofT
ofT
ofT
ofT
ofT
ofT
ofT
ofT
ofT
ofT
ofT
ofT
ofT
ofT
ofT
ofT
ofT
ofT
ofT
ofT
ofT
ofT
ofT
ofT
ofT
ofT
ofT
ofT
ofT
ofT
ofT
ofT
ofT
ofT
ofT
ofT
ofT
ofT
ofT
ofT
ofT
ofT
ofT
"}
(63,1,1) = {"
ofT
ofT
ofT
ofT
ofT
ofT
ofT
ofT
ofT
ofT
ofT
ofT
ofT
ofT
ofT
ofT
ofT
ofT
ofT
ofT
ofT
ofT
ofT
ofT
ofT
ofT
ofT
ofT
ofT
ofT
ofT
ofT
ofT
ofT
ofT
ofT
ofT
ofT
ofT
ofT
ofT
ofT
ofT
ofT
ofT
ofT
ofT
ofT
ofT
ofT
ofT
ofT
ofT
"}
(64,1,1) = {"
ofT
ofT
ofT
ofT
ofT
ofT
ofT
ofT
ofT
ofT
ofT
ofT
ofT
ofT
ofT
ofT
ofT
ofT
ofT
ofT
ofT
ofT
ofT
ofT
ofT
ofT
ofT
ofT
ofT
ofT
ofT
ofT
ofT
ofT
ofT
ofT
ofT
ofT
ofT
ofT
ofT
ofT
ofT
ofT
ofT
ofT
ofT
ofT
ofT
ofT
ofT
ofT
ofT
"}
(65,1,1) = {"
ofT
ofT
ofT
ofT
ofT
ofT
ofT
ofT
ofT
ofT
ofT
ofT
ofT
ofT
ofT
ofT
ofT
ofT
ofT
ofT
ofT
ofT
ofT
ofT
ofT
ofT
ofT
ofT
ofT
ofT
ofT
ofT
ofT
ofT
ofT
ofT
ofT
ofT
ofT
ofT
ofT
ofT
ofT
ofT
ofT
ofT
ofT
ofT
ofT
ofT
ofT
ofT
ofT
"}
(66,1,1) = {"
ofT
ofT
ofT
ofT
ofT
ofT
ofT
ofT
ofT
ofT
ofT
ofT
ofT
ofT
ofT
ofT
ofT
ofT
ofT
ofT
ofT
ofT
ofT
ofT
ofT
ofT
ofT
ofT
ofT
ofT
ofT
ofT
ofT
ofT
ofT
ofT
ofT
ofT
ofT
ofT
ofT
ofT
ofT
ofT
ofT
ofT
ofT
ofT
ofT
ofT
ofT
ofT
ofT
"}
(67,1,1) = {"
ofT
ofT
ofT
ofT
ofT
ofT
ofT
ofT
ofT
ofT
ofT
ofT
ofT
ofT
ofT
ofT
ofT
ofT
ofT
ofT
ofT
ofT
ofT
ofT
ofT
ofT
ofT
ofT
ofT
ofT
ofT
ofT
ofT
ofT
ofT
ofT
ofT
ofT
ofT
ofT
ofT
ofT
ofT
ofT
ofT
ofT
ofT
ofT
ofT
ofT
ofT
ofT
ofT
"}
(68,1,1) = {"
ofT
ofT
ofT
ofT
ofT
ofT
ofT
ofT
ofT
ofT
ofT
ofT
ofT
ofT
ofT
ofT
ofT
ofT
ofT
ofT
ofT
ofT
ofT
ofT
ofT
ofT
ofT
ofT
ofT
ofT
ofT
ofT
ofT
ofT
ofT
ofT
ofT
ofT
ofT
ofT
ofT
ofT
ofT
ofT
ofT
ofT
ofT
ofT
ofT
ofT
ofT
ofT
ofT
"}
(69,1,1) = {"
ofT
ofT
ofT
ofT
ofT
ofT
ofT
ofT
ofT
ofT
ofT
ofT
ofT
ofT
ofT
ofT
ofT
ofT
ofT
ofT
ofT
ofT
ofT
ofT
ofT
ofT
ofT
ofT
ofT
ofT
ofT
ofT
ofT
ofT
ofT
ofT
ofT
ofT
ofT
ofT
ofT
ofT
ofT
ofT
ofT
ofT
ofT
ofT
ofT
ofT
ofT
ofT
ofT
"}
(70,1,1) = {"
ofT
ofT
ofT
ofT
ofT
ofT
ofT
ofT
ofT
ofT
ofT
ofT
ofT
ofT
ofT
ofT
ofT
ofT
ofT
ofT
ofT
ofT
ofT
ofT
ofT
ofT
ofT
ofT
ofT
ofT
ofT
ofT
ofT
ofT
ofT
ofT
ofT
ofT
ofT
ofT
ofT
ofT
ofT
ofT
ofT
ofT
ofT
ofT
ofT
ofT
ofT
ofT
ofT
"}
(71,1,1) = {"
ofT
ofT
ofT
ofT
ofT
ofT
ofT
ofT
ofT
ofT
ofT
ofT
ofT
ofT
ofT
ofT
ofT
ofT
ofT
ofT
ofT
ofT
ofT
ofT
ofT
ofT
ofT
ofT
ofT
ofT
ofT
ofT
ofT
ofT
ofT
ofT
ofT
ofT
ofT
ofT
ofT
ofT
ofT
ofT
ofT
ofT
ofT
ofT
ofT
ofT
ofT
ofT
ofT
"}
(72,1,1) = {"
ofT
ofT
ofT
ofT
ofT
ofT
ofT
ofT
ofT
ofT
ofT
ofT
ofT
ofT
ofT
ofT
ofT
ofT
ofT
ofT
ofT
ofT
ofT
ofT
ofT
ofT
ofT
ofT
ofT
ofT
ofT
ofT
ofT
ofT
ofT
ofT
ofT
ofT
ofT
ofT
ofT
ofT
ofT
ofT
ofT
ofT
ofT
ofT
ofT
ofT
ofT
ofT
ofT
"}
(73,1,1) = {"
ofT
ofT
ofT
ofT
ofT
ofT
ofT
ofT
ofT
ofT
ofT
ofT
ofT
ofT
ofT
ofT
ofT
ofT
ofT
ofT
ofT
ofT
ofT
ofT
ofT
ofT
ofT
ofT
ofT
ofT
ofT
ofT
ofT
ofT
ofT
ofT
ofT
ofT
ofT
ofT
ofT
ofT
ofT
ofT
ofT
ofT
ofT
ofT
ofT
ofT
ofT
ofT
ofT
"}
(74,1,1) = {"
ofT
ofT
ofT
ofT
ofT
ofT
ofT
ofT
ofT
ofT
ofT
ofT
ofT
ofT
ofT
ofT
ofT
ofT
ofT
ofT
ofT
ofT
ofT
ofT
ofT
ofT
ofT
ofT
ofT
ofT
ofT
ofT
ofT
ofT
ofT
ofT
ofT
ofT
ofT
ofT
ofT
ofT
ofT
ofT
ofT
ofT
ofT
ofT
ofT
ofT
ofT
ofT
ofT
"}
(75,1,1) = {"
ofT
ofT
ofT
ofT
ofT
ofT
ofT
ofT
ofT
ofT
ofT
ofT
ofT
ofT
ofT
ofT
ofT
ofT
ofT
ofT
ofT
ofT
ofT
ofT
ofT
ofT
ofT
ofT
ofT
ofT
ofT
ofT
ofT
ofT
ofT
ofT
ofT
ofT
ofT
ofT
ofT
ofT
ofT
ofT
ofT
ofT
ofT
ofT
ofT
ofT
ofT
ofT
ofT
"}
(76,1,1) = {"
ofT
ofT
ofT
ofT
ofT
ofT
ofT
ofT
ofT
ofT
ofT
ofT
ofT
ofT
ofT
ofT
ofT
ofT
ofT
ofT
ofT
ofT
ofT
ofT
ofT
ofT
ofT
ofT
ofT
ofT
ofT
ofT
ofT
ofT
ofT
ofT
ofT
ofT
ofT
ofT
ofT
ofT
ofT
ofT
ofT
ofT
ofT
ofT
ofT
ofT
ofT
ofT
ofT
"}
(77,1,1) = {"
ofT
ofT
ofT
ofT
ofT
ofT
ofT
ofT
ofT
ofT
ofT
ofT
ofT
ofT
ofT
ofT
ofT
ofT
ofT
ofT
ofT
ofT
ofT
ofT
ofT
ofT
ofT
ofT
ofT
ofT
ofT
ofT
ofT
ofT
ofT
ofT
ofT
ofT
ofT
ofT
ofT
ofT
ofT
ofT
ofT
ofT
ofT
ofT
ofT
ofT
ofT
ofT
ofT
"}
(78,1,1) = {"
ofT
ofT
ofT
ofT
ofT
ofT
ofT
ofT
ofT
ofT
ofT
ofT
ofT
ofT
ofT
ofT
ofT
ofT
ofT
ofT
ofT
ofT
ofT
ofT
ofT
ofT
ofT
ofT
ofT
ofT
ofT
ofT
ofT
ofT
ofT
ofT
ofT
ofT
ofT
ofT
ofT
ofT
ofT
ofT
ofT
ofT
ofT
ofT
ofT
ofT
ofT
ofT
ofT
"}
(79,1,1) = {"
ofT
ofT
ofT
ofT
ofT
ofT
ofT
ofT
ofT
ofT
ofT
ofT
ofT
ofT
ofT
ofT
ofT
ofT
ofT
ofT
ofT
ofT
ofT
ofT
ofT
ofT
ofT
ofT
ofT
ofT
ofT
ofT
ofT
ofT
ofT
ofT
ofT
ofT
ofT
ofT
ofT
ofT
ofT
ofT
ofT
ofT
ofT
ofT
ofT
ofT
ofT
ofT
ofT
"}
(80,1,1) = {"
ofT
ofT
ofT
ofT
ofT
ofT
ofT
ofT
ofT
ofT
ofT
ofT
ofT
ofT
ofT
ofT
ofT
ofT
ofT
ofT
ofT
ofT
ofT
ofT
ofT
ofT
ofT
ofT
ofT
ofT
ofT
ofT
ofT
ofT
ofT
ofT
ofT
ofT
ofT
ofT
ofT
ofT
ofT
ofT
ofT
ofT
ofT
ofT
ofT
ofT
ofT
ofT
ofT
"}
(81,1,1) = {"
ofT
ofT
ofT
ofT
ofT
ofT
ofT
ofT
ofT
ofT
ofT
ofT
ofT
ofT
ofT
ofT
ofT
ofT
ofT
ofT
ofT
ofT
ofT
ofT
ofT
ofT
ofT
ofT
ofT
ofT
ofT
ofT
ofT
ofT
ofT
ofT
ofT
ofT
ofT
ofT
ofT
ofT
ofT
ofT
ofT
ofT
ofT
ofT
ofT
ofT
ofT
ofT
ofT
"}
(82,1,1) = {"
ofT
ofT
ofT
ofT
ofT
ofT
ofT
ofT
ofT
ofT
ofT
ofT
ofT
ofT
ofT
ofT
ofT
ofT
ofT
ofT
ofT
ofT
ofT
ofT
ofT
ofT
ofT
ofT
ofT
ofT
ofT
ofT
ofT
ofT
ofT
ofT
ofT
ofT
ofT
ofT
ofT
ofT
ofT
ofT
ofT
ofT
ofT
ofT
ofT
ofT
ofT
ofT
ofT
"}
(83,1,1) = {"
ofT
ofT
ofT
ofT
ofT
ofT
ofT
ofT
ofT
ofT
ofT
ofT
ofT
ofT
ofT
ofT
ofT
ofT
ofT
ofT
ofT
ofT
ofT
ofT
ofT
ofT
ofT
ofT
ofT
ofT
ofT
ofT
ofT
ofT
ofT
ofT
ofT
ofT
ofT
ofT
ofT
ofT
ofT
ofT
ofT
ofT
ofT
ofT
ofT
ofT
ofT
ofT
ofT
"}
(84,1,1) = {"
ofT
ofT
ofT
ofT
ofT
ofT
ofT
ofT
ofT
ofT
ofT
ofT
ofT
ofT
ofT
ofT
ofT
ofT
ofT
ofT
ofT
ofT
ofT
ofT
ofT
ofT
ofT
ofT
ofT
ofT
ofT
ofT
ofT
ofT
ofT
ofT
ofT
ofT
ofT
ofT
ofT
ofT
ofT
ofT
ofT
ofT
ofT
ofT
ofT
ofT
ofT
ofT
ofT
"}
(85,1,1) = {"
ofT
ofT
ofT
ofT
ofT
ofT
ofT
ofT
ofT
ofT
ofT
ofT
ofT
ofT
ofT
ofT
ofT
ofT
ofT
ofT
ofT
ofT
ofT
ofT
ofT
ofT
ofT
ofT
ofT
ofT
ofT
ofT
ofT
ofT
ofT
ofT
ofT
ofT
ofT
ofT
ofT
ofT
ofT
ofT
ofT
ofT
ofT
ofT
ofT
ofT
ofT
ofT
ofT
"}
(86,1,1) = {"
ofT
ofT
ofT
ofT
ofT
ofT
ofT
ofT
ofT
ofT
ofT
ofT
ofT
ofT
ofT
ofT
ofT
ofT
ofT
ofT
ofT
ofT
ofT
ofT
ofT
ofT
ofT
ofT
ofT
ofT
ofT
ofT
ofT
ofT
ofT
ofT
ofT
ofT
ofT
ofT
ofT
ofT
ofT
ofT
ofT
ofT
ofT
ofT
ofT
ofT
ofT
ofT
ofT
"}
(87,1,1) = {"
ofT
ofT
ofT
ofT
ofT
ofT
ofT
ofT
ofT
ofT
ofT
ofT
ofT
ofT
ofT
ofT
ofT
ofT
ofT
ofT
ofT
ofT
ofT
ofT
ofT
ofT
ofT
ofT
ofT
ofT
ofT
ofT
ofT
ofT
ofT
ofT
ofT
ofT
ofT
ofT
ofT
ofT
ofT
ofT
ofT
ofT
ofT
ofT
ofT
ofT
ofT
ofT
ofT
"}
(88,1,1) = {"
ofT
ofT
ofT
ofT
ofT
ofT
ofT
ofT
ofT
ofT
ofT
ofT
ofT
ofT
ofT
ofT
ofT
ofT
ofT
ofT
ofT
ofT
ofT
ofT
ofT
ofT
ofT
ofT
ofT
ofT
ofT
ofT
ofT
ofT
ofT
ofT
ofT
ofT
ofT
ofT
ofT
ofT
ofT
ofT
ofT
ofT
ofT
ofT
ofT
ofT
ofT
ofT
ofT
"}
(89,1,1) = {"
ofT
ofT
ofT
ofT
ofT
ofT
ofT
ofT
ofT
ofT
ofT
ofT
ofT
ofT
ofT
ofT
ofT
ofT
ofT
ofT
ofT
ofT
ofT
ofT
ofT
ofT
ofT
ofT
ofT
ofT
ofT
ofT
ofT
ofT
ofT
ofT
ofT
ofT
ofT
ofT
ofT
ofT
ofT
ofT
ofT
ofT
ofT
ofT
ofT
ofT
ofT
ofT
ofT
"}
(90,1,1) = {"
ofT
ofT
ofT
ofT
ofT
ofT
ofT
ofT
ofT
ofT
ofT
ofT
ofT
ofT
ofT
ofT
ofT
ofT
ofT
ofT
ofT
ofT
ofT
ofT
ofT
ofT
ofT
ofT
ofT
ofT
ofT
ofT
ofT
ofT
ofT
ofT
ofT
ofT
ofT
ofT
ofT
ofT
ofT
ofT
ofT
ofT
ofT
ofT
ofT
ofT
ofT
ofT
ofT
"}
(91,1,1) = {"
ofT
ofT
ofT
ofT
ofT
ofT
ofT
ofT
ofT
ofT
ofT
ofT
ofT
ofT
ofT
ofT
ofT
ofT
ofT
ofT
ofT
ofT
ofT
ofT
ofT
ofT
ofT
ofT
ofT
ofT
ofT
ofT
ofT
ofT
ofT
ofT
ofT
ofT
ofT
ofT
ofT
ofT
ofT
ofT
ofT
ofT
ofT
ofT
ofT
ofT
ofT
ofT
ofT
"}
(92,1,1) = {"
ofT
ofT
ofT
ofT
ofT
ofT
ofT
ofT
ofT
ofT
ofT
ofT
ofT
ofT
ofT
ofT
ofT
ofT
ofT
ofT
ofT
ofT
ofT
ofT
ofT
ofT
ofT
ofT
ofT
ofT
ofT
ofT
ofT
ofT
ofT
ofT
ofT
ofT
ofT
ofT
ofT
ofT
ofT
ofT
ofT
ofT
ofT
ofT
ofT
ofT
ofT
ofT
ofT
"}
(93,1,1) = {"
ofT
ofT
ofT
ofT
ofT
ofT
ofT
ofT
ofT
ofT
ofT
ofT
ofT
ofT
ofT
ofT
ofT
ofT
ofT
ofT
ofT
ofT
ofT
ofT
ofT
ofT
ofT
ofT
ofT
ofT
ofT
ofT
ofT
ofT
ofT
ofT
ofT
ofT
ofT
ofT
ofT
ofT
ofT
ofT
ofT
ofT
ofT
ofT
ofT
ofT
ofT
ofT
ofT
"}
(94,1,1) = {"
ofT
ofT
ofT
ofT
ofT
ofT
ofT
ofT
ofT
ofT
ofT
ofT
ofT
ofT
ofT
ofT
ofT
ofT
ofT
ofT
ofT
ofT
ofT
ofT
ofT
ofT
ofT
ofT
ofT
ofT
ofT
ofT
ofT
ofT
ofT
ofT
ofT
ofT
ofT
ofT
ofT
ofT
ofT
ofT
ofT
ofT
ofT
ofT
ofT
ofT
ofT
ofT
ofT
"}
(95,1,1) = {"
ofT
ofT
ofT
ofT
ofT
ofT
ofT
ofT
ofT
ofT
ofT
ofT
ofT
ofT
ofT
ofT
ofT
ofT
ofT
ofT
ofT
ofT
ofT
ofT
ofT
ofT
ofT
ofT
ofT
ofT
ofT
ofT
ofT
ofT
ofT
ofT
ofT
ofT
ofT
ofT
ofT
ofT
ofT
ofT
ofT
ofT
ofT
ofT
ofT
ofT
ofT
ofT
ofT
"}
(96,1,1) = {"
ofT
ofT
ofT
ofT
ofT
ofT
ofT
ofT
ofT
ofT
ofT
ofT
ofT
ofT
ofT
ofT
ofT
ofT
ofT
ofT
ofT
ofT
ofT
ofT
ofT
ofT
ofT
ofT
ofT
ofT
ofT
ofT
ofT
ofT
ofT
ofT
ofT
ofT
ofT
ofT
ofT
ofT
ofT
ofT
ofT
ofT
ofT
ofT
ofT
ofT
ofT
ofT
ofT
"}
(97,1,1) = {"
ofT
ofT
ofT
ofT
ofT
ofT
ofT
ofT
ofT
ofT
ofT
ofT
ofT
ofT
ofT
ofT
ofT
ofT
ofT
ofT
ofT
ofT
ofT
ofT
ofT
ofT
ofT
ofT
ofT
ofT
ofT
ofT
ofT
ofT
ofT
ofT
ofT
ofT
ofT
ofT
ofT
ofT
ofT
ofT
ofT
ofT
ofT
ofT
ofT
ofT
ofT
ofT
ofT
"}
(98,1,1) = {"
ofT
ofT
ofT
ofT
ofT
ofT
ofT
ofT
ofT
ofT
ofT
ofT
ofT
ofT
ofT
ofT
ofT
ofT
ofT
ofT
ofT
ofT
ofT
ofT
ofT
ofT
ofT
ofT
ofT
ofT
ofT
ofT
ofT
ofT
ofT
ofT
ofT
ofT
ofT
ofT
ofT
ofT
ofT
ofT
ofT
ofT
ofT
ofT
ofT
ofT
ofT
ofT
ofT
"}
(99,1,1) = {"
ofT
ofT
ofT
ofT
ofT
ofT
ofT
ofT
ofT
ofT
ofT
ofT
ofT
ofT
ofT
ofT
ofT
ofT
ofT
ofT
ofT
ofT
ofT
ofT
ofT
ofT
ofT
ofT
ofT
ofT
ofT
ofT
ofT
ofT
ofT
ofT
ofT
ofT
ofT
ofT
ofT
ofT
ofT
ofT
ofT
ofT
ofT
ofT
ofT
ofT
ofT
ofT
ofT
"}
(100,1,1) = {"
ofT
ofT
ofT
ofT
ofT
ofT
ofT
ofT
ofT
ofT
ofT
ofT
ofT
ofT
ofT
ofT
ofT
ofT
ofT
ofT
ofT
ofT
ofT
ofT
ofT
ofT
ofT
ofT
ofT
ofT
ofT
ofT
ofT
ofT
ofT
ofT
ofT
ofT
ofT
ofT
ofT
ofT
ofT
ofT
ofT
ofT
ofT
ofT
ofT
ofT
ofT
ofT
ofT
"}
(101,1,1) = {"
ofT
ofT
ofT
ofT
ofT
ofT
ofT
ofT
ofT
ofT
ofT
ofT
ofT
ofT
ofT
ofT
ofT
ofT
ofT
ofT
ofT
ofT
ofT
ofT
ofT
ofT
ofT
ofT
ofT
ofT
ofT
ofT
ofT
ofT
ofT
ofT
ofT
ofT
ofT
ofT
ofT
ofT
ofT
ofT
ofT
ofT
ofT
ofT
ofT
ofT
ofT
ofT
ofT
"}
(102,1,1) = {"
ofT
ofT
ofT
ofT
ofT
ofT
ofT
ofT
ofT
ofT
ofT
ofT
ofT
ofT
ofT
ofT
ofT
ofT
ofT
ofT
ofT
ofT
ofT
ofT
ofT
ofT
ofT
ofT
ofT
ofT
ofT
ofT
ofT
ofT
ofT
ofT
ofT
ofT
ofT
ofT
ofT
ofT
ofT
ofT
ofT
ofT
ofT
ofT
ofT
ofT
ofT
ofT
ofT
"}
(103,1,1) = {"
ofT
ofT
ofT
ofT
ofT
ofT
ofT
ofT
ofT
ofT
ofT
ofT
ofT
ofT
ofT
ofT
ofT
ofT
ofT
ofT
ofT
ofT
ofT
ofT
ofT
ofT
ofT
ofT
ofT
ofT
ofT
ofT
ofT
ofT
ofT
ofT
ofT
ofT
ofT
ofT
ofT
ofT
ofT
ofT
ofT
ofT
ofT
ofT
ofT
ofT
ofT
ofT
ofT
"}
(104,1,1) = {"
ofT
ofT
ofT
ofT
ofT
ofT
ofT
ofT
ofT
ofT
ofT
ofT
ofT
ofT
ofT
ofT
ofT
ofT
ofT
ofT
ofT
ofT
ofT
ofT
ofT
ofT
ofT
ofT
ofT
ofT
ofT
ofT
ofT
ofT
ofT
ofT
ofT
ofT
ofT
ofT
ofT
ofT
ofT
ofT
ofT
ofT
ofT
ofT
ofT
ofT
ofT
ofT
ofT
"}
(105,1,1) = {"
ofT
ofT
ofT
ofT
ofT
ofT
ofT
ofT
ofT
ofT
ofT
ofT
ofT
ofT
ofT
ofT
ofT
ofT
ofT
ofT
ofT
ofT
ofT
ofT
ofT
ofT
ofT
ofT
ofT
ofT
ofT
ofT
ofT
ofT
ofT
ofT
ofT
ofT
ofT
ofT
ofT
ofT
ofT
ofT
ofT
ofT
ofT
ofT
ofT
ofT
ofT
ofT
ofT
"}
(106,1,1) = {"
ofT
ofT
ofT
ofT
ofT
ofT
ofT
ofT
ofT
ofT
ofT
ofT
ofT
ofT
ofT
ofT
ofT
ofT
ofT
ofT
ofT
ofT
ofT
ofT
ofT
ofT
ofT
ofT
ofT
ofT
ofT
ofT
ofT
ofT
ofT
ofT
ofT
ofT
ofT
ofT
ofT
ofT
ofT
ofT
ofT
ofT
ofT
ofT
ofT
ofT
ofT
ofT
ofT
"}
(107,1,1) = {"
ofT
ofT
ofT
ofT
ofT
ofT
ofT
ofT
ofT
ofT
ofT
ofT
ofT
ofT
ofT
ofT
ofT
ofT
ofT
ofT
ofT
ofT
ofT
ofT
ofT
ofT
ofT
ofT
ofT
ofT
ofT
ofT
ofT
ofT
ofT
ofT
ofT
ofT
ofT
ofT
ofT
ofT
ofT
ofT
ofT
ofT
ofT
ofT
ofT
ofT
ofT
ofT
ofT
"}
