//MAP CONVERTED BY dmm2tgm.py THIS HEADER COMMENT PREVENTS RECONVERSION, DO NOT REMOVE
"bU" = (
/obj/structure/spider/stickyweb,
/turf/open/indestructible/ground/inside/mountain,
/area/f13/caves)
"cu" = (
/obj/structure/spider/stickyweb,
/obj/structure/barricade/wooden,
/turf/open/floor/holofloor/wood,
/area/f13/caves)
"cV" = (
/obj/structure/spider/cocoon,
/obj/structure/spider/stickyweb,
/obj/structure/spider/stickyweb,
/turf/open/floor/holofloor/wood,
/area/f13/caves)
"di" = (
/obj/structure/spider/stickyweb,
/obj/structure/spider/stickyweb,
/obj/structure/spider/stickyweb,
/turf/open/indestructible/ground/inside/mountain,
/area/f13/caves)
"dQ" = (
/obj/structure/spider/cocoon,
/turf/open/floor/wood/f13/housewoodbroken2,
/area/f13/caves)
"em" = (
/obj/structure/barricade/wooden,
/obj/structure/barricade/wooden/crude,
/turf/closed/mineral/random/low_chance_prison,
/area/f13/caves)
"eE" = (
/obj/structure/spider/stickyweb,
/obj/structure/spider/stickyweb,
/obj/structure/spider/stickyweb,
/obj/structure/barricade/wooden,
/turf/closed/mineral/random/low_chance_prison,
/area/f13/caves)
"fL" = (
/obj/structure/spider/eggcluster,
/obj/structure/spider/stickyweb,
/obj/structure/spider/stickyweb,
/obj/structure/spider/stickyweb,
/turf/open/floor/wood/f13/housewoodbroken,
/area/f13/caves)
"gT" = (
/turf/closed/wall/f13/wood/house/shack{
	baseturfs = /turf/open/indestructible/ground/inside/mountain;
	name = "basement wall"
	},
/area/f13/caves)
"hM" = (
/turf/open/indestructible/ground/inside/mountain,
/area/f13/caves)
"hR" = (
/obj/structure/spider/stickyweb,
/obj/structure/spider/stickyweb,
/obj/structure/spider/stickyweb,
/turf/open/floor/wood/f13/oakbase,
/area/f13/caves)
"hZ" = (
/obj/structure/spider/eggcluster,
/turf/open/floor/holofloor/wood,
/area/f13/caves)
"jM" = (
/turf/closed/mineral/random/low_chance_prison,
/area/f13/caves)
"kc" = (
/obj/structure/spider/stickyweb,
/turf/closed/mineral/random/low_chance_prison,
/area/f13/caves)
"ke" = (
/obj/structure/spider/eggcluster,
/obj/structure/spider/stickyweb,
/obj/structure/spider/stickyweb,
/turf/open/floor/wood/f13/housewoodbroken,
/area/f13/caves)
"kI" = (
/obj/structure/spider/stickyweb,
/obj/structure/barricade/wooden,
/turf/closed/mineral/random/low_chance_prison,
/area/f13/caves)
"lr" = (
/obj/structure/spider/stickyweb,
/turf/open/floor/wood/f13/housewoodbroken2,
/area/f13/caves)
"mc" = (
/obj/structure/spider/stickyweb,
/obj/structure/spider/stickyweb,
/obj/structure/barricade/wooden,
/turf/open/floor/holofloor/wood,
/area/f13/caves)
"nF" = (
/obj/structure/spider/eggcluster,
/obj/structure/spider/stickyweb,
/obj/structure/spider/stickyweb,
/turf/open/indestructible/ground/inside/mountain,
/area/f13/caves)
"nV" = (
/obj/structure/spider/stickyweb,
/turf/open/floor/wood/f13/housewoodbroken,
/area/f13/caves)
"oe" = (
/obj/structure/barricade/wooden/crude/snow,
/turf/open/indestructible/ground/inside/mountain,
/area/f13/caves)
"og" = (
/obj/structure/spider/stickyweb,
/obj/structure/spider/stickyweb,
/turf/closed/mineral/random/low_chance_prison,
/area/f13/caves)
"pe" = (
/turf/open/floor/wood/f13/housewoodbroken,
/area/f13/caves)
"pq" = (
/obj/structure/barricade/wooden,
/turf/open/floor/holofloor/wood,
/area/f13/caves)
"qz" = (
/obj/structure/spider/stickyweb,
/obj/structure/spider/stickyweb,
/turf/open/floor/holofloor/wood,
/area/f13/caves)
"ra" = (
/obj/structure/barricade/wooden/planks,
/obj/structure/barricade/wooden/crude/snow,
/turf/open/floor/wood/f13/housewoodbroken,
/area/f13/caves)
"sq" = (
/obj/structure/spider/stickyweb,
/obj/structure/spider/stickyweb,
/turf/open/floor/wood/f13/oakbase,
/area/f13/caves)
"sr" = (
/turf/open/floor/wood/f13/housewoodbroken4,
/area/f13/caves)
"uk" = (
/obj/structure/barricade/wooden/planks,
/turf/open/indestructible/ground/inside/mountain,
/area/f13/caves)
"uI" = (
/obj/structure/spider/stickyweb,
/obj/structure/barricade/wooden,
/obj/structure/barricade/wooden/crude,
/turf/closed/mineral/random/low_chance_prison,
/area/f13/caves)
"vm" = (
/obj/structure/spider/eggcluster,
/obj/structure/spider/stickyweb,
/obj/structure/spider/stickyweb,
/obj/structure/spider/stickyweb,
/obj/structure/spider/stickyweb,
/turf/open/floor/holofloor/wood,
/area/f13/caves)
"vn" = (
/turf/closed/mineral/random/high_chance_prison,
/area/f13/caves)
"xo" = (
/obj/structure/spider/stickyweb,
/obj/structure/spider/stickyweb,
/obj/structure/barricade/wooden/crude,
/turf/closed/mineral/random/low_chance_prison,
/area/f13/caves)
"xw" = (
/obj/structure/spider/stickyweb,
/obj/structure/spider/stickyweb,
/turf/open/floor/wood/f13/housewoodbroken,
/area/f13/caves)
"xx" = (
/turf/open/floor/wood/f13/housewoodbroken3,
/area/f13/caves)
"yl" = (
/obj/structure/barricade/wooden,
/turf/closed/mineral/random/high_chance_prison,
/area/f13/caves)
"Bm" = (
/obj/structure/spider/stickyweb,
/turf/open/floor/wood/f13/oakbase,
/area/f13/caves)
"Cz" = (
/obj/structure/spider/stickyweb,
/obj/structure/spider/stickyweb,
/obj/structure/barricade/wooden,
/turf/open/floor/wood/f13/housewoodbroken,
/area/f13/caves)
"CE" = (
/obj/structure/spider/stickyweb,
/obj/structure/barricade/wooden,
/turf/open/indestructible/ground/inside/mountain,
/area/f13/caves)
"CT" = (
/obj/structure/spider/stickyweb,
/obj/structure/barricade/wooden,
/obj/structure/barricade/wooden/crude/snow,
/turf/open/indestructible/ground/inside/mountain,
/area/f13/caves)
"Dg" = (
/obj/structure/barricade/wooden/crude,
/obj/structure/barricade/wooden/planks,
/turf/open/indestructible/ground/inside/mountain,
/area/f13/caves)
"Dj" = (
/obj/structure/spider/stickyweb,
/obj/structure/spider/stickyweb,
/obj/structure/barricade/wooden,
/obj/structure/barricade/wooden/planks/pregame,
/turf/closed/mineral/random/high_chance_prison,
/area/f13/caves)
"Dp" = (
/obj/structure/spider/stickyweb,
/turf/open/floor/holofloor/wood,
/area/f13/caves)
"DA" = (
/obj/structure/barricade/wooden,
/obj/structure/barricade/wooden/crude/snow,
/turf/open/floor/wood/f13/housewoodbroken,
/area/f13/caves)
"FC" = (
/obj/structure/spider/stickyweb,
/obj/structure/spider/stickyweb,
/obj/structure/spider/stickyweb,
/obj/structure/barricade/wooden/crude,
/turf/open/floor/holofloor/wood,
/area/f13/caves)
"FP" = (
/obj/structure/barricade/wooden,
/obj/structure/barricade/wooden/crude/snow,
/turf/open/floor/holofloor/wood,
/area/f13/caves)
"FU" = (
/obj/structure/spider/stickyweb,
/obj/structure/spider/stickyweb,
/obj/structure/barricade/wooden,
/turf/closed/mineral/random/low_chance_prison,
/area/f13/caves)
"Gd" = (
/turf/closed/wall/f13/wood/house/broken,
/area/f13/caves)
"HN" = (
/obj/structure/spider/stickyweb,
/obj/structure/barricade/wooden,
/obj/structure/barricade/wooden/planks,
/turf/open/indestructible/ground/inside/mountain,
/area/f13/caves)
"Ir" = (
/obj/structure/barricade/wooden,
/obj/structure/barricade/wooden/crude/snow,
/turf/open/indestructible/ground/inside/mountain,
/area/f13/caves)
"IA" = (
/obj/structure/spider/eggcluster,
/obj/structure/spider/stickyweb,
/obj/structure/spider/stickyweb,
/obj/structure/barricade/wooden,
/turf/open/floor/holofloor/wood,
/area/f13/caves)
"Jk" = (
/obj/structure/spider/stickyweb,
/obj/structure/spider/stickyweb,
/obj/structure/barricade/wooden,
/obj/structure/barricade/wooden/crude,
/turf/open/indestructible/ground/inside/mountain,
/area/f13/caves)
"JS" = (
/obj/structure/spider/stickyweb,
/obj/structure/spider/stickyweb,
/turf/open/indestructible/ground/inside/mountain,
/area/f13/caves)
"Lc" = (
/obj/structure/spider/cocoon,
/obj/structure/spider/stickyweb,
/obj/structure/spider/stickyweb,
/obj/structure/spider/stickyweb,
/turf/open/indestructible/ground/inside/mountain,
/area/f13/caves)
"LV" = (
/turf/open/floor/wood/f13/housewoodbroken2,
/area/f13/caves)
"Ms" = (
/obj/structure/barricade/wooden,
/turf/closed/mineral/random/low_chance_prison,
/area/f13/caves)
"MA" = (
/obj/structure/spider/stickyweb,
/obj/structure/spider/stickyweb,
/obj/structure/spider/stickyweb,
/turf/open/floor/holofloor/wood,
/area/f13/caves)
"MH" = (
/obj/structure/spider/stickyweb,
/obj/structure/spider/stickyweb,
/turf/open/floor/wood/f13/housewoodbroken3,
/area/f13/caves)
"ML" = (
/obj/structure/spider/stickyweb,
/obj/structure/spider/stickyweb,
/turf/open/floor/wood/f13/housewoodbroken4,
/area/f13/caves)
"Nr" = (
/obj/structure/spider/stickyweb,
/obj/structure/spider/stickyweb,
/obj/structure/spider/stickyweb,
/turf/open/floor/wood/f13/housewoodbroken4,
/area/f13/caves)
"NA" = (
/obj/structure/spider/stickyweb,
/turf/closed/mineral/random/high_chance_prison,
/area/f13/caves)
"Sc" = (
/obj/structure/spider/stickyweb,
/obj/structure/spider/stickyweb,
/turf/open/floor/wood/f13/housewoodbroken2,
/area/f13/caves)
"Sl" = (
/obj/structure/spider/stickyweb,
/obj/structure/spider/stickyweb,
/turf/closed/mineral/random/high_chance_prison,
/area/f13/caves)
"Sp" = (
/obj/structure/barricade/wooden,
/obj/structure/barricade/wooden/planks,
/turf/open/indestructible/ground/inside/mountain,
/area/f13/caves)
"SI" = (
/obj/structure/spider/cocoon,
/obj/structure/spider/stickyweb,
/turf/open/floor/holofloor/wood,
/area/f13/caves)
"SS" = (
/obj/structure/spider/stickyweb,
/turf/open/floor/wood/f13/housewoodbroken3,
/area/f13/caves)
"ST" = (
/turf/open/floor/holofloor/wood,
/area/f13/caves)
"Ti" = (
/obj/structure/barricade/wooden,
/obj/structure/barricade/wooden,
/turf/closed/mineral/random/high_chance_prison,
/area/f13/caves)
"Tu" = (
/obj/structure/barricade/wooden/planks,
/turf/open/floor/wood/f13/housewoodbroken3,
/area/f13/caves)
"TL" = (
/obj/structure/barricade/wooden,
/obj/structure/barricade/wooden/crude,
/turf/closed/mineral/random/high_chance_prison,
/area/f13/caves)
"Vp" = (
/obj/structure/barricade/wooden/crude,
/turf/open/indestructible/ground/inside/mountain,
/area/f13/caves)
"VG" = (
/obj/structure/spider/stickyweb,
/turf/open/floor/wood/f13/housewoodbroken4,
/area/f13/caves)
"VV" = (
/obj/structure/spider/cocoon,
/obj/structure/spider/stickyweb,
/obj/structure/spider/stickyweb,
/turf/open/indestructible/ground/inside/mountain,
/area/f13/caves)
"WT" = (
/obj/structure/barricade/wooden,
/obj/structure/barricade/wooden/planks,
/turf/open/floor/holofloor/wood,
/area/f13/caves)
"WU" = (
/turf/open/floor/wood/f13/oakbase,
/area/f13/caves)
"Yg" = (
/obj/structure/spider/stickyweb,
/obj/structure/barricade/wooden,
/turf/closed/mineral/random/high_chance_prison,
/area/f13/caves)
"Yh" = (
/obj/structure/barricade/wooden,
/obj/structure/barricade/wooden/planks/pregame,
/turf/open/floor/holofloor/wood,
/area/f13/caves)
"Ym" = (
/obj/structure/barricade/wooden,
/turf/open/indestructible/ground/inside/mountain,
/area/f13/caves)
"YA" = (
/obj/structure/spider/stickyweb,
/obj/structure/barricade/wooden,
/obj/structure/barricade/wooden/crude/snow,
/turf/closed/mineral/random/low_chance_prison,
/area/f13/caves)

(1,1,1) = {"
jM
jM
jM
jM
jM
jM
jM
jM
jM
jM
jM
jM
jM
jM
jM
jM
jM
jM
jM
jM
jM
jM
jM
jM
jM
jM
jM
jM
gT
gT
jM
jM
jM
jM
jM
"}
(2,1,1) = {"
jM
jM
jM
jM
jM
jM
jM
jM
jM
jM
jM
jM
jM
jM
jM
jM
jM
jM
jM
jM
jM
jM
jM
jM
jM
Gd
Gd
kc
FU
kc
Gd
jM
jM
jM
jM
"}
(3,1,1) = {"
jM
jM
jM
jM
jM
jM
jM
jM
jM
jM
jM
jM
jM
jM
jM
jM
jM
jM
jM
jM
jM
jM
jM
jM
jM
kc
bU
JS
CT
hM
FU
jM
jM
jM
jM
"}
(4,1,1) = {"
jM
jM
jM
jM
jM
jM
jM
jM
jM
jM
jM
jM
jM
jM
jM
jM
jM
jM
jM
jM
jM
jM
jM
jM
kc
sr
Lc
JS
hM
bU
hM
ML
jM
jM
jM
"}
(5,1,1) = {"
jM
jM
jM
jM
jM
jM
jM
jM
jM
jM
jM
jM
jM
Ms
Ms
bU
bU
gT
gT
gT
gT
Ms
Ms
Ms
bU
qz
hM
jM
kc
hM
DA
xw
jM
jM
jM
"}
(6,1,1) = {"
jM
jM
jM
jM
jM
jM
kc
og
kc
jM
jM
kc
WU
bU
Ym
Ym
bU
uk
HN
jM
gT
jM
kc
jM
uk
lr
kc
kc
jM
og
JS
Dp
hM
jM
jM
"}
(7,1,1) = {"
jM
jM
jM
jM
jM
kc
bU
hM
ST
Dp
ke
ST
Bm
bU
bU
jM
hM
bU
hM
kc
gT
jM
jM
kc
bU
qz
og
sr
og
og
VV
bU
bU
jM
jM
"}
(8,1,1) = {"
jM
jM
jM
jM
Ms
CE
Sp
bU
bU
Dp
cV
nV
Dp
jM
jM
jM
jM
hM
JS
kc
jM
kc
kc
JS
Dp
ke
Dp
ST
ST
kI
kI
bU
kc
jM
jM
"}
(9,1,1) = {"
jM
jM
jM
jM
hM
bU
WU
kc
jM
SS
Tu
Dp
lr
jM
Ms
kc
kc
hM
bU
Lc
WU
uk
bU
bU
LV
xx
cV
ra
ST
YA
jM
hM
og
jM
jM
"}
(10,1,1) = {"
jM
jM
jM
jM
bU
Dp
VG
uI
og
kc
jM
ST
ST
nV
WT
VG
bU
bU
hM
Dp
Dp
jM
jM
jM
jM
hM
CE
Yh
pq
qz
Dp
bU
kc
jM
jM
"}
(11,1,1) = {"
jM
jM
jM
jM
bU
qz
xw
ST
bU
jM
kc
jM
jM
bU
Dp
Dp
bU
Ym
JS
Dp
Dp
jM
og
kc
bU
hM
NA
bU
hM
bU
bU
bU
jM
jM
jM
"}
(12,1,1) = {"
jM
jM
jM
jM
jM
pe
SS
Dp
lr
bU
hM
jM
jM
jM
hM
bU
jM
jM
jM
nV
ST
ST
Dp
MA
ST
Yg
NA
di
JS
kc
kc
jM
jM
jM
jM
"}
(13,1,1) = {"
jM
jM
jM
vn
vn
NA
vn
vn
vn
Sl
bU
CE
hM
bU
bU
jM
jM
Ms
Ms
ST
cV
xx
qz
xw
Dj
yl
Ti
vn
NA
og
jM
jM
jM
jM
jM
"}
(14,1,1) = {"
jM
jM
gT
vn
NA
NA
NA
vn
vn
vn
Ms
Ir
bU
bU
jM
jM
em
kc
hM
Dp
SS
sq
cu
lr
Dp
NA
Sl
gT
Gd
gT
gT
jM
jM
jM
jM
"}
(15,1,1) = {"
jM
jM
Gd
NA
bU
bU
vn
TL
yl
vn
jM
gT
Gd
gT
kc
kc
hM
bU
JS
ST
FP
IA
ST
pe
ST
SS
vn
Ms
Gd
jM
jM
jM
jM
jM
jM
"}
(16,1,1) = {"
jM
jM
Gd
Dg
bU
bU
JS
JS
NA
vn
jM
jM
jM
Gd
jM
bU
bU
Dp
qz
Vp
kI
og
kc
ST
ST
hM
JS
kc
gT
jM
jM
jM
jM
jM
jM
"}
(17,1,1) = {"
jM
jM
gT
hR
Bm
dQ
Dp
bU
vn
vn
Ms
Ms
kc
gT
kc
bU
bU
cV
Sc
bU
kc
jM
og
og
Ms
jM
bU
kc
gT
jM
jM
jM
jM
jM
jM
"}
(18,1,1) = {"
jM
vn
yl
NA
ML
hZ
nV
JS
bU
kc
YA
VG
Dp
sq
MA
bU
bU
xx
JS
JS
jM
og
kc
jM
kc
hM
JS
jM
Gd
jM
jM
jM
jM
jM
jM
"}
(19,1,1) = {"
vn
vn
vn
yl
mc
xw
SS
og
di
di
JS
Dp
pe
ST
MH
bU
vn
vn
JS
JS
hM
jM
og
xo
hM
nF
di
og
gT
jM
jM
jM
jM
jM
jM
"}
(20,1,1) = {"
jM
vn
vn
vn
vn
yl
NA
kc
kc
jM
Dp
nV
fL
qz
vn
vn
NA
vn
JS
WU
JS
Nr
Dp
LV
hM
Jk
eE
og
jM
jM
jM
jM
jM
jM
jM
"}
(21,1,1) = {"
jM
jM
vn
vn
vn
vn
gT
gT
Gd
Gd
cu
Cz
ST
FC
vn
NA
Sl
JS
di
SI
Dp
ST
pe
FC
og
kI
Ms
jM
jM
jM
jM
jM
jM
jM
jM
"}
(22,1,1) = {"
jM
jM
jM
jM
jM
jM
jM
jM
gT
Gd
gT
Ym
bU
Sc
ST
MA
Dp
oe
hM
xx
nV
qz
ST
og
og
jM
jM
jM
jM
jM
jM
jM
jM
jM
jM
"}
(23,1,1) = {"
jM
jM
jM
jM
jM
jM
jM
jM
jM
jM
jM
kc
JS
di
SS
vm
xw
bU
hM
og
kc
og
kc
gT
jM
jM
jM
jM
jM
jM
jM
jM
jM
jM
jM
"}
(24,1,1) = {"
jM
jM
jM
jM
jM
jM
jM
jM
jM
jM
jM
jM
kc
jM
kc
kc
Ms
Ms
kc
kc
kc
gT
gT
gT
jM
jM
jM
jM
jM
jM
jM
jM
jM
jM
jM
"}
(25,1,1) = {"
jM
jM
jM
jM
jM
jM
jM
jM
jM
jM
jM
jM
jM
jM
jM
jM
jM
jM
jM
jM
jM
jM
jM
jM
jM
jM
jM
jM
jM
jM
jM
jM
jM
jM
jM
"}
