//MAP CONVERTED BY dmm2tgm.py THIS HEADER COMMENT PREVENTS RECONVERSION, DO NOT REMOVE
"a" = (
/turf/closed/mineral/random/low_chance_prison,
/area/f13/caves)
"c" = (
/turf/closed/mineral/random/high_chance_prison,
/area/f13/caves)

(1,1,1) = {"
a
a
a
a
a
a
a
a
a
a
a
a
a
a
a
a
a
a
a
a
a
a
a
a
c
a
a
a
a
a
a
a
a
a
a
a
a
a
a
a
a
a
a
"}
(2,1,1) = {"
a
a
a
a
a
a
a
a
a
a
a
a
a
a
a
a
a
a
a
a
a
a
a
a
a
c
a
a
a
a
a
a
a
a
a
a
a
a
a
a
a
a
a
"}
(3,1,1) = {"
a
a
a
c
c
a
a
a
a
a
a
a
c
a
c
c
a
a
a
a
a
a
a
a
a
c
c
a
a
a
a
a
c
a
c
a
a
a
a
a
a
a
a
"}
(4,1,1) = {"
a
a
c
a
a
a
a
a
a
a
a
a
a
a
a
a
c
a
a
c
c
a
a
a
a
a
a
c
a
a
a
a
a
a
a
c
c
a
a
a
a
a
a
"}
(5,1,1) = {"
a
c
a
a
a
a
a
a
a
a
a
a
a
a
a
a
a
a
a
a
a
c
c
c
a
a
a
a
c
a
a
a
a
a
a
a
a
c
c
c
a
a
a
"}
(6,1,1) = {"
c
a
a
a
a
a
a
a
c
c
c
a
a
a
a
a
a
a
a
a
a
a
a
a
c
a
a
a
a
a
a
a
a
a
a
a
a
a
a
a
a
a
a
"}
(7,1,1) = {"
a
a
a
a
a
a
a
a
a
a
c
c
c
c
a
a
a
a
a
a
a
a
a
a
a
a
a
a
a
a
a
a
a
a
a
a
a
a
a
a
a
a
a
"}
