//MAP CONVERTED BY dmm2tgm.py THIS HEADER COMMENT PREVENTS RECONVERSION, DO NOT REMOVE
"a" = (
/turf/closed/mineral/random/low_chance_prison,
/area/f13/caves)
"c" = (
/turf/closed/indestructible/rock/smoothing,
/area/f13/caves)
"p" = (
/turf/closed/mineral/random/high_chance_prison,
/area/f13/caves)

(1,1,1) = {"
a
a
a
a
a
a
a
a
a
a
a
a
a
"}
(2,1,1) = {"
a
a
a
c
c
a
a
a
a
a
a
a
a
"}
(3,1,1) = {"
a
a
c
c
c
p
p
p
p
c
a
a
a
"}
(4,1,1) = {"
a
a
c
c
p
p
p
p
c
c
c
a
a
"}
(5,1,1) = {"
a
a
c
c
c
p
p
p
c
c
c
a
a
"}
(6,1,1) = {"
a
a
a
c
c
p
p
p
c
c
a
a
a
"}
(7,1,1) = {"
a
a
a
a
a
p
p
p
p
a
a
a
a
"}
(8,1,1) = {"
a
a
a
a
a
a
a
a
a
a
a
a
a
"}
(9,1,1) = {"
a
a
a
a
a
a
a
a
a
a
a
a
a
"}
(10,1,1) = {"
a
c
a
a
a
a
a
a
a
a
a
a
a
"}
(11,1,1) = {"
a
c
c
a
a
a
a
a
a
a
a
a
a
"}
(12,1,1) = {"
a
c
c
a
a
a
a
a
a
a
a
a
a
"}
(13,1,1) = {"
a
c
a
a
a
a
p
p
a
a
a
a
a
"}
(14,1,1) = {"
a
a
a
a
a
p
p
p
a
a
a
a
a
"}
(15,1,1) = {"
a
a
a
a
p
p
p
a
a
a
a
a
a
"}
(16,1,1) = {"
a
a
a
p
p
p
a
a
a
a
a
a
a
"}
(17,1,1) = {"
a
a
p
p
p
a
a
a
a
a
c
c
a
"}
(18,1,1) = {"
a
p
p
p
a
a
a
a
a
c
c
c
a
"}
(19,1,1) = {"
a
a
a
a
a
a
a
a
a
c
c
c
a
"}
(20,1,1) = {"
a
a
a
a
a
a
a
a
a
a
c
a
a
"}
(21,1,1) = {"
a
a
a
a
a
a
a
a
a
a
a
a
a
"}
(22,1,1) = {"
a
a
a
a
a
a
a
a
a
a
a
a
a
"}
(23,1,1) = {"
a
a
a
a
c
c
a
a
a
a
a
a
a
"}
(24,1,1) = {"
a
a
a
c
c
c
c
a
a
a
a
a
a
"}
(25,1,1) = {"
a
a
c
c
c
c
c
a
a
a
a
a
a
"}
(26,1,1) = {"
a
a
a
c
c
a
a
a
a
a
a
a
a
"}
