//MAP CONVERTED BY dmm2tgm.py THIS HEADER COMMENT PREVENTS RECONVERSION, DO NOT REMOVE
"a" = (
/turf/closed/mineral/random/low_chance_prison,
/area/f13/caves)
"u" = (
/turf/closed/indestructible/rock/smoothing,
/area/f13/caves)
"U" = (
/turf/closed/mineral/random/high_chance_prison,
/area/f13/caves)

(1,1,1) = {"
a
a
a
a
a
a
a
a
a
a
a
a
"}
(2,1,1) = {"
a
a
a
a
a
a
a
a
a
a
a
a
"}
(3,1,1) = {"
a
a
a
U
U
a
a
a
a
a
a
a
"}
(4,1,1) = {"
a
a
U
U
U
a
a
a
a
a
a
a
"}
(5,1,1) = {"
a
U
U
U
a
a
a
a
a
a
a
a
"}
(6,1,1) = {"
a
a
a
a
a
a
a
a
a
a
a
a
"}
(7,1,1) = {"
a
a
a
a
a
U
a
a
a
a
a
a
"}
(8,1,1) = {"
a
a
a
a
a
a
U
a
a
a
a
a
"}
(9,1,1) = {"
a
a
a
a
a
a
U
a
a
a
a
a
"}
(10,1,1) = {"
a
a
a
U
U
U
U
a
a
a
a
a
"}
(11,1,1) = {"
a
a
a
U
u
u
U
a
U
U
a
a
"}
(12,1,1) = {"
a
a
a
u
u
u
U
a
U
U
U
a
"}
(13,1,1) = {"
a
a
a
u
u
U
U
U
a
a
U
a
"}
(14,1,1) = {"
a
a
a
U
U
u
U
U
a
a
U
a
"}
(15,1,1) = {"
a
a
a
U
u
u
u
U
a
a
a
a
"}
(16,1,1) = {"
a
a
a
U
u
U
U
U
a
a
a
a
"}
(17,1,1) = {"
a
a
a
U
a
U
a
a
a
a
a
a
"}
(18,1,1) = {"
a
a
a
U
a
a
a
a
a
a
a
a
"}
(19,1,1) = {"
a
a
a
a
a
U
a
U
U
a
a
a
"}
(20,1,1) = {"
a
a
a
U
U
a
a
a
U
a
a
a
"}
(21,1,1) = {"
a
a
a
U
a
a
a
a
a
a
a
a
"}
(22,1,1) = {"
a
a
a
a
a
a
a
a
a
a
a
a
"}
(23,1,1) = {"
a
a
a
a
U
a
a
a
a
a
a
a
"}
(24,1,1) = {"
a
a
a
a
U
a
a
a
a
a
a
a
"}
(25,1,1) = {"
a
a
a
a
a
a
a
a
a
a
a
a
"}
(26,1,1) = {"
a
a
a
a
a
a
a
a
a
a
a
a
"}
