//MAP CONVERTED BY dmm2tgm.py THIS HEADER COMMENT PREVENTS RECONVERSION, DO NOT REMOVE
"a" = (
/turf/closed/mineral/random/low_chance_prison,
/area/f13/caves)
"b" = (
/turf/closed/indestructible/rock,
/area/f13/caves)
"d" = (
/turf/closed/mineral/random/high_chance_prison,
/area/f13/caves)

(1,1,1) = {"
a
a
a
a
a
a
a
a
a
a
a
a
a
a
a
a
b
b
b
a
b
b
b
b
b
a
a
a
a
a
a
d
a
a
a
a
a
a
a
a
b
b
b
"}
(2,1,1) = {"
a
a
a
a
a
a
a
a
a
a
a
b
b
a
a
a
a
b
b
b
b
b
b
b
a
a
a
a
a
a
a
d
d
a
a
a
a
a
a
b
b
b
b
"}
(3,1,1) = {"
a
a
a
a
a
a
a
a
a
a
a
b
a
a
b
b
a
a
b
b
b
a
a
a
a
a
a
a
a
a
a
a
d
d
a
a
a
a
b
b
b
b
a
"}
(4,1,1) = {"
a
a
a
a
a
a
a
a
a
a
a
a
a
b
b
b
b
b
b
b
b
b
a
a
a
a
a
a
a
a
a
a
a
a
d
a
a
b
b
b
a
a
a
"}
(5,1,1) = {"
d
d
d
d
d
d
a
a
a
a
a
a
b
b
b
b
b
a
a
a
b
b
b
b
a
a
a
a
a
a
a
a
a
a
a
d
a
b
b
a
a
b
a
"}
(6,1,1) = {"
d
d
d
d
d
a
a
a
a
a
a
b
b
b
b
a
a
a
a
a
a
b
b
b
b
a
a
a
a
a
a
a
a
a
a
a
a
a
b
a
b
b
a
"}
(7,1,1) = {"
a
a
a
a
d
a
a
a
a
a
a
a
a
a
a
a
a
a
a
a
a
a
a
b
b
a
a
a
a
a
a
a
a
a
a
a
a
a
a
a
a
a
a
"}
