//MAP CONVERTED BY dmm2tgm.py THIS HEADER COMMENT PREVENTS RECONVERSION, DO NOT REMOVE
"a" = (
/turf/closed/mineral/random/low_chance_prison,
/area/f13/caves)
"h" = (
/turf/closed/indestructible/rock,
/area/f13/caves)
"y" = (
/turf/closed/mineral/random/high_chance_prison,
/area/f13/caves)

(1,1,1) = {"
a
a
a
a
a
a
a
a
a
a
a
a
a
a
"}
(2,1,1) = {"
a
a
a
a
a
a
a
a
a
a
a
a
a
a
"}
(3,1,1) = {"
a
a
a
a
a
a
h
h
a
a
a
a
a
a
"}
(4,1,1) = {"
a
a
a
a
h
h
h
h
a
a
a
a
a
a
"}
(5,1,1) = {"
a
a
h
h
h
h
a
a
a
a
a
a
a
a
"}
(6,1,1) = {"
a
a
h
h
a
a
a
a
a
a
a
a
a
a
"}
(7,1,1) = {"
a
a
a
a
a
a
a
a
a
a
a
a
a
a
"}
(8,1,1) = {"
a
a
a
a
a
a
a
a
y
y
a
a
a
a
"}
(9,1,1) = {"
a
a
a
a
a
y
y
y
a
a
a
a
a
a
"}
(10,1,1) = {"
a
a
a
a
y
y
y
a
a
a
a
a
a
a
"}
(11,1,1) = {"
a
a
a
y
y
a
a
a
a
a
a
a
h
h
"}
(12,1,1) = {"
a
a
a
a
a
a
a
a
a
a
a
h
h
h
"}
(13,1,1) = {"
a
a
a
a
a
a
a
a
a
a
a
h
h
y
"}
(14,1,1) = {"
a
a
a
a
a
a
a
a
a
a
h
h
y
y
"}
(15,1,1) = {"
h
h
a
a
a
a
a
a
a
a
h
h
y
y
"}
(16,1,1) = {"
h
h
a
a
a
a
a
a
a
a
h
y
y
y
"}
(17,1,1) = {"
y
h
h
a
a
a
a
h
a
a
h
h
y
y
"}
(18,1,1) = {"
y
h
h
a
a
a
h
h
a
a
h
h
h
y
"}
(19,1,1) = {"
y
y
h
a
a
h
h
h
a
a
a
h
h
h
"}
(20,1,1) = {"
y
y
y
a
a
h
h
a
a
a
a
a
a
h
"}
(21,1,1) = {"
y
y
h
a
a
a
h
a
a
a
a
a
a
h
"}
(22,1,1) = {"
y
y
h
a
a
a
a
a
a
a
a
a
a
a
"}
(23,1,1) = {"
y
h
h
a
h
h
a
a
a
a
a
a
a
a
"}
(24,1,1) = {"
y
h
h
a
h
h
h
a
a
a
a
a
a
a
"}
(25,1,1) = {"
h
h
a
a
h
h
h
h
a
a
a
a
a
a
"}
(26,1,1) = {"
h
h
a
a
a
h
h
h
a
a
a
a
a
a
"}
(27,1,1) = {"
h
a
a
a
a
a
h
h
h
a
a
a
a
a
"}
(28,1,1) = {"
a
a
a
a
a
a
a
a
h
a
a
a
a
a
"}
(29,1,1) = {"
a
a
a
a
a
a
a
a
a
a
a
a
a
a
"}
(30,1,1) = {"
a
a
a
a
a
a
a
a
a
a
a
a
a
a
"}
(31,1,1) = {"
a
a
a
a
a
a
a
a
a
a
a
a
a
a
"}
(32,1,1) = {"
a
a
a
a
a
a
a
a
a
a
a
a
a
a
"}
(33,1,1) = {"
a
a
a
a
a
a
a
a
a
a
a
a
a
a
"}
(34,1,1) = {"
a
a
a
a
a
a
a
a
a
a
a
a
a
a
"}
