//MAP CONVERTED BY dmm2tgm.py THIS HEADER COMMENT PREVENTS RECONVERSION, DO NOT REMOVE
"a" = (
/turf/closed/mineral/random/low_chance_prison,
/area/f13/caves)
"b" = (
/turf/open/floor/wood/f13/carpet{
	icon_state = "torncarpet11"
	},
/area/f13/caves)
"c" = (
/turf/open/indestructible/ground/inside/mountain,
/area/f13/caves)
"g" = (
/obj/structure/simple_door/metal/iron,
/obj/structure/barricade/wooden/planks,
/turf/open/floor/f13{
	icon_state = "darkdirtysolid"
	},
/area/f13/caves)
"h" = (
/obj/effect/decal/cleanable/cobweb,
/obj/effect/decal/cleanable/dirt,
/obj/structure/cursed_slot_machine{
	name = "Reno Golden Tooth slot machine"
	},
/turf/open/floor/wood/f13/carpet,
/area/f13/caves)
"i" = (
/obj/structure/table/wood/poker,
/obj/item/clothing/head/fedora,
/turf/open/floor/wood/f13/carpet,
/area/f13/caves)
"j" = (
/obj/effect/decal/cleanable/dirt,
/turf/open/floor/wood/f13/carpet,
/area/f13/caves)
"k" = (
/obj/machinery/light/broken,
/turf/open/floor/wood/f13/carpet,
/area/f13/caves)
"l" = (
/turf/open/floor/wood/f13/carpet,
/area/f13/caves)
"m" = (
/turf/closed/indestructible/rock/smoothing/abovemob,
/area/f13/caves)
"n" = (
/obj/structure/spider/stickyweb,
/obj/item/clothing/under/suit/checkered,
/obj/item/clothing/shoes/laceup,
/turf/open/floor/f13{
	icon_state = "darkdirtysolid"
	},
/area/f13/caves)
"p" = (
/obj/structure/table/roulette,
/turf/open/floor/wood/f13/carpet,
/area/f13/caves)
"q" = (
/obj/effect/decal/cleanable/cobweb/cobweb2,
/turf/open/floor/wood/f13/carpet,
/area/f13/caves)
"t" = (
/obj/effect/spawner/lootdrop/f13/cash_random_high,
/turf/open/floor/wood/f13/carpet,
/area/f13/caves)
"v" = (
/obj/structure/chair/stool/retro/backed{
	dir = 1
	},
/turf/open/floor/wood/f13/carpet,
/area/f13/caves)
"x" = (
/obj/structure/chair/stool/retro,
/turf/open/floor/wood/f13/carpet,
/area/f13/caves)
"z" = (
/obj/structure/table/wood/poker,
/obj/item/toy/cards/deck/syndicate{
	pixel_y = 8
	},
/turf/open/floor/wood/f13/carpet,
/area/f13/caves)
"A" = (
/obj/structure/table/wood/poker,
/obj/effect/spawner/lootdrop/f13/cash_random_high,
/turf/open/floor/wood/f13/carpet,
/area/f13/caves)
"D" = (
/obj/effect/decal/remains/human,
/turf/open/floor/wood/f13/carpet,
/area/f13/caves)
"E" = (
/obj/structure/table/wood/poker,
/turf/open/floor/wood/f13/carpet,
/area/f13/caves)
"F" = (
/turf/open/floor/plasteel/f13/vault_floor/floor/floorsolid{
	icon_state = "rampdowntop";
	color = "#A47449";
	name = "wooden stairs"
	},
/area/f13/caves)
"H" = (
/obj/effect/decal/cleanable/dirt,
/turf/open/floor/wood/f13/carpet{
	icon_state = "torncarpet9"
	},
/area/f13/caves)
"I" = (
/turf/closed/wall/mineral/brick,
/area/f13/caves)
"K" = (
/turf/closed/mineral/random/high_chance_prison,
/area/f13/caves)
"L" = (
/obj/effect/decal/cleanable/dirt,
/turf/closed/wall/f13/ruins,
/area/f13/caves)
"M" = (
/obj/machinery/computer/slot_machine,
/turf/open/floor/wood/f13/carpet,
/area/f13/caves)
"N" = (
/obj/structure/chair/stool/retro,
/turf/open/floor/wood/f13/carpet{
	icon_state = "torncarpet3"
	},
/area/f13/caves)
"Q" = (
/obj/structure/chair/stool/retro,
/obj/machinery/light/broken{
	dir = 8
	},
/turf/open/floor/wood/f13/carpet,
/area/f13/caves)
"R" = (
/turf/open/floor/wood/f13/carpet{
	icon_state = "torncarpet4"
	},
/area/f13/caves)
"S" = (
/obj/structure/chair/stool/retro,
/obj/effect/decal/cleanable/dirt,
/turf/open/floor/wood/f13/carpet,
/area/f13/caves)
"U" = (
/turf/closed/wall/f13/ruins,
/area/f13/caves)
"V" = (
/turf/open/floor/plasteel/f13/vault_floor/misc/vaultrust,
/area/f13/caves)
"W" = (
/obj/structure/chair/stool/retro/backed,
/turf/open/floor/wood/f13/carpet,
/area/f13/caves)
"Y" = (
/obj/effect/decal/cleanable/dirt,
/obj/machinery/light/broken{
	dir = 4
	},
/turf/open/floor/wood/f13/carpet,
/area/f13/caves)
"Z" = (
/obj/structure/girder,
/turf/open/floor/plasteel/f13/vault_floor/plating,
/area/f13/caves)

(1,1,1) = {"
a
a
m
m
a
K
a
a
a
a
a
a
a
"}
(2,1,1) = {"
m
m
a
a
a
a
a
a
a
a
a
a
a
"}
(3,1,1) = {"
m
a
I
I
I
I
I
I
I
Z
I
a
a
"}
(4,1,1) = {"
a
a
I
h
S
M
Q
M
S
j
I
a
a
"}
(5,1,1) = {"
a
a
I
M
x
M
x
M
S
j
I
a
a
"}
(6,1,1) = {"
a
a
I
j
j
D
l
l
j
k
I
a
a
"}
(7,1,1) = {"
a
a
I
x
x
j
l
x
p
v
I
a
a
"}
(8,1,1) = {"
a
a
I
i
A
x
L
x
t
l
I
a
a
"}
(9,1,1) = {"
a
a
I
W
z
x
U
U
l
j
U
a
a
"}
(10,1,1) = {"
m
a
I
l
E
N
R
S
p
v
U
U
a
"}
(11,1,1) = {"
m
a
I
q
Y
b
H
x
l
U
U
U
c
"}
(12,1,1) = {"
a
a
I
I
I
g
I
I
I
U
U
c
c
"}
(13,1,1) = {"
a
a
I
U
U
n
I
a
a
c
c
c
a
"}
(14,1,1) = {"
a
a
I
V
F
U
I
a
a
a
c
a
a
"}
(15,1,1) = {"
a
a
I
I
I
I
I
a
a
a
a
a
a
"}
(16,1,1) = {"
a
a
a
a
a
a
a
a
a
a
a
a
a
"}
