//MAP CONVERTED BY dmm2tgm.py THIS HEADER COMMENT PREVENTS RECONVERSION, DO NOT REMOVE
"a" = (
/turf/closed/mineral/random/low_chance_prison,
/area/f13/caves)
"z" = (
/turf/closed/indestructible/rock/smoothing,
/area/f13/caves)
"Z" = (
/turf/closed/mineral/random/high_chance_prison,
/area/f13/caves)

(1,1,1) = {"
a
a
a
a
a
a
a
a
a
a
a
a
a
"}
(2,1,1) = {"
a
a
a
a
a
a
a
Z
Z
a
a
a
a
"}
(3,1,1) = {"
a
a
a
Z
Z
a
a
Z
Z
a
a
a
a
"}
(4,1,1) = {"
a
a
z
z
Z
Z
Z
Z
Z
Z
a
a
a
"}
(5,1,1) = {"
a
z
z
z
z
z
z
Z
Z
Z
Z
Z
a
"}
(6,1,1) = {"
a
a
z
z
z
z
z
Z
Z
a
Z
Z
Z
"}
(7,1,1) = {"
a
a
Z
Z
Z
z
Z
a
Z
Z
Z
a
Z
"}
(8,1,1) = {"
a
a
a
a
Z
Z
Z
Z
a
Z
Z
a
a
"}
(9,1,1) = {"
a
a
a
a
a
Z
Z
Z
a
a
a
a
a
"}
(10,1,1) = {"
a
a
a
a
Z
Z
a
a
a
a
a
a
a
"}
(11,1,1) = {"
a
a
a
a
Z
a
a
a
a
a
a
a
a
"}
(12,1,1) = {"
a
a
a
a
a
a
a
a
a
a
a
a
a
"}
(13,1,1) = {"
a
a
a
a
a
a
a
a
a
a
a
a
a
"}
(14,1,1) = {"
a
a
a
a
a
a
a
a
a
a
a
a
a
"}
(15,1,1) = {"
a
a
a
a
a
a
a
a
a
a
a
a
a
"}
(16,1,1) = {"
a
a
a
a
a
a
a
a
a
a
a
a
a
"}
