//MAP CONVERTED BY dmm2tgm.py THIS HEADER COMMENT PREVENTS RECONVERSION, DO NOT REMOVE
"a" = (
/turf/closed/mineral/random/low_chance_prison,
/area/f13/caves)
"S" = (
/turf/closed/mineral/random/high_chance_prison,
/area/f13/caves)
"T" = (
/turf/closed/indestructible/rock,
/area/f13/caves)

(1,1,1) = {"
a
a
a
a
a
a
a
a
a
a
a
a
a
a
T
T
a
"}
(2,1,1) = {"
a
a
a
a
a
a
a
a
a
S
S
a
a
a
T
T
T
"}
(3,1,1) = {"
a
a
a
a
a
a
a
S
S
S
S
a
S
S
a
T
T
"}
(4,1,1) = {"
a
a
a
S
S
a
S
S
S
S
a
S
S
a
a
a
a
"}
(5,1,1) = {"
a
a
S
S
S
a
S
S
S
S
S
S
a
a
a
a
a
"}
(6,1,1) = {"
a
a
S
S
S
S
S
S
S
a
a
a
a
a
a
a
a
"}
(7,1,1) = {"
a
a
a
a
S
S
a
a
a
a
a
a
a
a
a
a
a
"}
(8,1,1) = {"
a
a
a
S
S
a
a
T
T
a
S
S
S
a
a
a
a
"}
(9,1,1) = {"
a
a
S
a
a
T
T
a
a
a
S
a
S
a
a
a
a
"}
(10,1,1) = {"
a
a
a
a
T
T
a
a
a
a
S
a
S
a
a
a
a
"}
(11,1,1) = {"
a
a
a
T
T
a
a
a
a
a
a
S
a
S
a
a
a
"}
(12,1,1) = {"
a
a
T
a
a
a
a
a
a
a
a
S
S
S
a
a
a
"}
(13,1,1) = {"
a
a
a
a
a
a
a
a
a
a
a
a
S
S
a
a
a
"}
(14,1,1) = {"
a
a
a
a
a
a
a
a
a
a
a
S
S
S
a
a
a
"}
(15,1,1) = {"
a
a
a
a
a
a
a
S
a
S
S
S
a
S
a
a
a
"}
(16,1,1) = {"
a
a
a
a
a
a
a
S
S
a
a
a
a
S
a
a
a
"}
(17,1,1) = {"
a
a
a
S
a
S
S
a
a
T
S
a
a
a
a
a
a
"}
(18,1,1) = {"
a
a
a
S
S
S
a
a
T
T
T
a
a
a
a
a
a
"}
(19,1,1) = {"
a
a
a
a
S
S
S
a
T
T
a
S
a
a
a
a
a
"}
(20,1,1) = {"
a
a
a
a
a
S
S
S
a
T
a
S
a
a
a
a
a
"}
(21,1,1) = {"
a
a
a
a
a
a
a
a
a
a
S
S
a
a
a
a
a
"}
(22,1,1) = {"
a
a
a
a
a
a
a
a
a
a
a
S
a
a
a
a
a
"}
(23,1,1) = {"
a
a
a
a
a
a
a
a
a
a
a
a
a
a
a
a
a
"}
(24,1,1) = {"
a
a
a
a
a
a
a
a
a
a
a
a
a
a
a
a
a
"}
(25,1,1) = {"
a
a
a
a
a
a
a
a
a
a
a
a
a
a
a
a
a
"}
