//MAP CONVERTED BY dmm2tgm.py THIS HEADER COMMENT PREVENTS RECONVERSION, DO NOT REMOVE
"a" = (
/turf/open/indestructible/ground/inside/mountain,
/area/f13/caves)
"f" = (
/obj/structure/simple_door/tentflap_leather,
/turf/open/indestructible/ground/inside/mountain,
/area/f13/caves)
"g" = (
/obj/structure/fluff/rails,
/turf/open/indestructible/ground/inside/mountain,
/area/f13/caves)
"h" = (
/obj/structure/nest/mob/molerat{
	dir = 8;
	layer = 3.01
	},
/turf/open/indestructible/ground/inside/mountain,
/area/f13/caves)
"k" = (
/obj/structure/fluff/rails,
/obj/structure/barricade/sandbags,
/turf/open/indestructible/ground/inside/mountain,
/area/f13/caves)
"l" = (
/obj/structure/nest/mob/molerat{
	dir = 4;
	pixel_y = 18
	},
/turf/open/indestructible/ground/inside/mountain,
/area/f13/caves)
"n" = (
/obj/structure/barricade/tentleathercorner{
	opacity = 0;
	dir = 4
	},
/turf/open/indestructible/ground/inside/mountain,
/area/f13/caves)
"r" = (
/obj/structure/barricade/wooden{
	opacity = 1
	},
/obj/structure/barricade/bars{
	layer = 3.01
	},
/turf/open/indestructible/ground/inside/mountain,
/area/f13/caves)
"t" = (
/obj/structure/fluff/rails{
	icon_state = "rails-b1";
	pixel_y = -3;
	pixel_x = -14;
	plane = -15
	},
/turf/open/indestructible/ground/inside/mountain,
/area/f13/caves)
"v" = (
/obj/structure/table/wood/junk,
/obj/effect/spawner/lootdrop/f13/medical/wasteland/meds,
/turf/open/indestructible/ground/inside/mountain,
/area/f13/caves)
"w" = (
/obj/structure/destructible/tribal_torch/lit,
/turf/open/indestructible/ground/inside/mountain,
/area/f13/caves)
"x" = (
/turf/closed/mineral/random/high_chance_prison,
/area/f13/caves)
"y" = (
/obj/structure/fluff/rails{
	icon_state = "rails-b1";
	pixel_y = -3;
	pixel_x = -12;
	plane = -15
	},
/turf/open/indestructible/ground/inside/mountain,
/area/f13/caves)
"z" = (
/obj/structure/plasticflaps/narrowcrevice,
/turf/open/indestructible/ground/inside/mountain,
/area/f13/caves)
"C" = (
/obj/structure/nest/mob/raider/biker{
	dir = 8
	},
/turf/open/indestructible/ground/inside/mountain,
/area/f13/caves)
"E" = (
/turf/closed/wall/f13/wood{
	baseturfs = /turf/open/indestructible/ground/inside/mountain
	},
/area/f13/caves)
"F" = (
/turf/closed/indestructible/rock/smoothing/abovemob,
/area/f13/caves)
"G" = (
/obj/structure/nest/mob/raider{
	dir = 4
	},
/turf/open/indestructible/ground/inside/mountain,
/area/f13/caves)
"I" = (
/obj/structure/nest/mob/raider{
	dir = 1
	},
/turf/open/indestructible/ground/inside/mountain,
/area/f13/caves)
"J" = (
/obj/structure/closet/crate/leftfootlocker,
/obj/effect/spawner/lootdrop/f13/cash_random_high,
/turf/open/indestructible/ground/inside/mountain,
/area/f13/caves)
"K" = (
/obj/structure/bed/mattress,
/turf/open/indestructible/ground/inside/mountain,
/area/f13/caves)
"L" = (
/obj/structure/bed/mattress{
	dir = 4
	},
/turf/open/indestructible/ground/inside/mountain,
/area/f13/caves)
"M" = (
/obj/structure/destructible/tribal_torch/wall/lit{
	dir = 4;
	light_color = "#c0c7d0";
	layer = 4.3
	},
/turf/open/indestructible/ground/inside/mountain,
/area/f13/caves)
"O" = (
/turf/closed/mineral/random/low_chance_prison,
/area/f13/caves)
"Q" = (
/obj/structure/nest/spawner/molerat,
/turf/open/indestructible/ground/inside/mountain,
/area/f13/caves)
"R" = (
/obj/structure/barricade/sandbags,
/turf/open/indestructible/ground/inside/mountain,
/area/f13/caves)
"T" = (
/obj/structure/barricade/tentleatheredge{
	dir = 8
	},
/turf/open/indestructible/ground/inside/mountain,
/area/f13/caves)
"U" = (
/obj/structure/fluff/rails{
	icon_state = "rails-b2";
	pixel_y = -4;
	plane = -15
	},
/turf/open/indestructible/ground/inside/mountain,
/area/f13/caves)
"X" = (
/obj/structure/barricade/tentleatheredge,
/turf/open/indestructible/ground/inside/mountain,
/area/f13/caves)
"Y" = (
/obj/structure/fluff/rails{
	icon_state = "rails-b2";
	pixel_y = -2;
	plane = -15
	},
/turf/open/indestructible/ground/inside/mountain,
/area/f13/caves)

(1,1,1) = {"
O
O
O
O
O
O
O
O
O
"}
(2,1,1) = {"
O
O
r
a
U
O
O
F
F
"}
(3,1,1) = {"
O
O
O
a
Y
Q
O
F
F
"}
(4,1,1) = {"
O
F
O
a
t
O
O
O
F
"}
(5,1,1) = {"
F
O
O
a
g
O
O
O
O
"}
(6,1,1) = {"
F
O
r
a
g
a
r
O
O
"}
(7,1,1) = {"
F
O
O
a
g
R
O
O
O
"}
(8,1,1) = {"
O
O
O
a
g
R
O
O
O
"}
(9,1,1) = {"
O
O
O
a
g
R
O
O
O
"}
(10,1,1) = {"
O
O
r
a
g
O
O
x
O
"}
(11,1,1) = {"
O
Q
z
a
g
O
O
O
O
"}
(12,1,1) = {"
O
a
O
O
O
O
O
x
O
"}
(13,1,1) = {"
O
a
z
a
O
O
O
O
O
"}
(14,1,1) = {"
O
O
r
a
g
a
r
O
O
"}
(15,1,1) = {"
O
O
O
a
g
O
O
O
O
"}
(16,1,1) = {"
O
O
O
a
g
O
O
O
O
"}
(17,1,1) = {"
O
O
O
a
Y
a
O
O
O
"}
(18,1,1) = {"
F
O
r
l
g
a
r
O
O
"}
(19,1,1) = {"
F
O
O
a
g
a
O
O
F
"}
(20,1,1) = {"
O
x
O
a
g
a
O
O
F
"}
(21,1,1) = {"
O
x
x
a
Y
h
O
O
F
"}
(22,1,1) = {"
O
x
x
x
Y
O
O
O
O
"}
(23,1,1) = {"
T
T
n
x
x
x
x
x
x
"}
(24,1,1) = {"
v
L
X
G
x
x
x
x
x
"}
(25,1,1) = {"
a
M
f
a
Y
O
O
O
O
"}
(26,1,1) = {"
K
E
r
a
t
w
r
O
O
"}
(27,1,1) = {"
O
O
O
a
g
I
O
O
O
"}
(28,1,1) = {"
O
O
O
a
g
O
O
O
O
"}
(29,1,1) = {"
O
O
O
a
g
O
O
x
O
"}
(30,1,1) = {"
O
O
r
a
g
O
O
x
O
"}
(31,1,1) = {"
O
O
O
R
k
O
O
x
O
"}
(32,1,1) = {"
O
O
O
C
g
a
O
O
O
"}
(33,1,1) = {"
O
O
O
a
g
a
O
O
O
"}
(34,1,1) = {"
O
O
r
w
y
J
r
O
O
"}
