//MAP CONVERTED BY dmm2tgm.py THIS HEADER COMMENT PREVENTS RECONVERSION, DO NOT REMOVE
"a" = (
/turf/closed/mineral/random/high_chance_prison,
/area/f13/caves)
"G" = (
/turf/closed/indestructible/rock/smoothing,
/area/f13/caves)
"N" = (
/turf/closed/mineral/random/low_chance_prison,
/area/f13/caves)

(1,1,1) = {"
N
N
N
N
N
N
N
N
N
N
N
N
N
"}
(2,1,1) = {"
N
N
N
N
N
N
N
N
N
N
N
N
N
"}
(3,1,1) = {"
N
N
N
N
N
N
N
a
a
a
a
N
N
"}
(4,1,1) = {"
N
N
N
N
N
N
N
a
G
G
G
G
N
"}
(5,1,1) = {"
N
N
N
N
N
N
N
N
a
a
G
G
N
"}
(6,1,1) = {"
N
N
N
N
N
N
N
N
N
a
a
G
N
"}
(7,1,1) = {"
N
N
N
N
N
N
N
N
N
N
a
N
N
"}
(8,1,1) = {"
N
N
N
N
N
N
N
N
N
N
N
a
N
"}
(9,1,1) = {"
N
N
N
N
N
N
N
N
N
N
N
N
N
"}
(10,1,1) = {"
N
N
a
G
G
N
N
N
N
N
N
N
N
"}
(11,1,1) = {"
N
N
a
G
G
a
N
N
N
N
N
N
N
"}
(12,1,1) = {"
N
N
a
G
a
a
N
N
N
N
N
N
N
"}
(13,1,1) = {"
N
N
N
a
a
N
N
N
N
N
N
N
N
"}
(14,1,1) = {"
N
N
N
a
a
a
N
N
N
N
N
N
N
"}
(15,1,1) = {"
N
N
N
N
a
N
N
N
N
N
N
N
N
"}
(16,1,1) = {"
G
G
a
N
N
N
N
N
N
N
N
N
N
"}
(17,1,1) = {"
G
a
a
N
N
N
N
N
N
N
N
N
N
"}
(18,1,1) = {"
a
a
N
N
N
N
N
N
G
G
N
N
N
"}
(19,1,1) = {"
a
N
N
N
N
N
N
G
G
G
a
N
N
"}
(20,1,1) = {"
N
N
N
N
N
N
N
N
G
a
a
N
N
"}
(21,1,1) = {"
N
N
N
N
N
N
N
N
a
a
a
N
N
"}
(22,1,1) = {"
N
N
N
N
N
N
N
N
a
a
N
N
N
"}
(23,1,1) = {"
N
N
N
N
N
N
N
N
a
N
N
N
N
"}
(24,1,1) = {"
N
N
N
N
N
N
N
N
N
N
N
N
N
"}
(25,1,1) = {"
N
N
N
N
N
N
N
N
N
N
N
N
N
"}
(26,1,1) = {"
N
N
N
N
N
N
N
N
N
N
N
N
N
"}
