//MAP CONVERTED BY dmm2tgm.py THIS HEADER COMMENT PREVENTS RECONVERSION, DO NOT REMOVE
"a" = (
/turf/closed/mineral/random/low_chance_prison,
/area/f13/caves)
"c" = (
/obj/item/assembly/igniter{
	pixel_x = -17;
	pixel_y = 6
	},
/turf/open/indestructible/ground/outside/sidewalk{
	sunlight_state = 0
	},
/area/f13/caves)
"d" = (
/turf/open/indestructible/ground/inside/mountain,
/area/f13/caves)
"e" = (
/obj/structure/table/wood/settler,
/obj/item/stack/sheet/mineral/uranium,
/obj/item/stack/sheet/mineral/uranium,
/obj/item/stack/sheet/mineral/uranium,
/obj/item/stack/sheet/mineral/uranium,
/obj/item/stack/sheet/mineral/uranium,
/obj/item/stack/ore/uranium{
	pixel_y = 9;
	pixel_x = -13
	},
/turf/open/indestructible/ground/outside/sidewalk{
	sunlight_state = 0
	},
/area/f13/caves)
"f" = (
/obj/structure/barricade/tentclothcorner{
	dir = 4;
	layer = 4.28;
	opacity = 0
	},
/turf/open/indestructible/ground/inside/mountain,
/area/f13/caves)
"g" = (
/obj/structure/barricade/tentclothcorner{
	opacity = 0;
	dir = 8
	},
/turf/open/indestructible/ground/inside/mountain,
/area/f13/caves)
"h" = (
/turf/closed/wall/f13/store{
	desc = "A pre-War wall made of solid concrete.";
	name = "basement wall";
	baseturfs = /turf/open/indestructible/ground/inside/mountain
	},
/area/f13/caves)
"i" = (
/obj/structure/table/wood/settler,
/obj/item/grenade/chem_grenade{
	pixel_y = 9
	},
/obj/item/grenade/chem_grenade{
	pixel_y = 4;
	pixel_x = 6
	},
/obj/item/stack/cable_coil/green,
/obj/item/assembly/timer{
	pixel_x = 16;
	pixel_y = -1
	},
/obj/item/assembly/igniter{
	pixel_x = -17;
	pixel_y = 6
	},
/turf/open/indestructible/ground/outside/sidewalk{
	sunlight_state = 0
	},
/area/f13/caves)
"j" = (
/obj/structure/barricade/tentclothcorner{
	dir = 1;
	opacity = 0;
	pixel_x = 3
	},
/turf/open/indestructible/ground/inside/mountain,
/area/f13/caves)
"k" = (
/obj/effect/decal/cleanable/dirt/dust,
/turf/open/indestructible/ground/outside/sidewalk{
	sunlight_state = 0
	},
/area/f13/caves)
"l" = (
/obj/item/pickaxe/mini,
/obj/effect/decal/remains/human{
	plane = -4;
	layer = 3.01;
	pixel_y = -9;
	pixel_x = 3
	},
/turf/open/indestructible/ground/inside/mountain,
/area/f13/caves)
"m" = (
/obj/structure/barricade/tentclothcorner{
	opacity = 0;
	dir = 8;
	pixel_x = -3
	},
/turf/open/indestructible/ground/inside/mountain,
/area/f13/caves)
"o" = (
/obj/structure/chair/folding{
	dir = 8
	},
/turf/open/indestructible/ground/inside/mountain,
/area/f13/caves)
"p" = (
/obj/structure/table,
/obj/item/reagent_containers/food/drinks/bottle/whiskey{
	name = "Jeddore Premium";
	pixel_y = 16;
	layer = 4.01;
	pixel_x = -11
	},
/obj/item/toy/cards/deck/syndicate{
	pixel_y = 8
	},
/turf/open/indestructible/ground/inside/mountain,
/area/f13/caves)
"q" = (
/obj/structure/barricade/tentclothedge{
	dir = 4;
	opacity = 0;
	pixel_x = 4
	},
/turf/open/indestructible/ground/inside/mountain,
/area/f13/caves)
"r" = (
/obj/effect/decal/cleanable/dirt/dust,
/obj/structure/chair/comfy/plywood{
	dir = 4
	},
/turf/open/indestructible/ground/outside/sidewalk{
	sunlight_state = 0
	},
/area/f13/caves)
"s" = (
/turf/closed/wall/f13/ruins,
/area/f13/caves)
"t" = (
/obj/item/flashlight/lantern{
	on = 1;
	pixel_y = 4;
	layer = 4.29;
	pixel_x = -14
	},
/obj/item/stack/ore/uranium{
	pixel_y = 9;
	pixel_x = -13
	},
/turf/open/indestructible/ground/inside/mountain,
/area/f13/caves)
"u" = (
/obj/structure/table,
/obj/item/flashlight/lantern{
	on = 1;
	pixel_y = 4;
	layer = 4.29;
	pixel_x = -14
	},
/obj/item/book/manual/nuclear,
/turf/open/indestructible/ground/inside/mountain,
/area/f13/caves)
"v" = (
/turf/open/indestructible/ground/outside/sidewalk{
	sunlight_state = 0
	},
/area/f13/caves)
"w" = (
/obj/structure/barricade/tentclothedge{
	dir = 8;
	pixel_x = -2
	},
/turf/open/indestructible/ground/inside/mountain,
/area/f13/caves)
"x" = (
/obj/machinery/workbench/forge,
/obj/item/stack/ore/uranium{
	pixel_y = 1;
	pixel_x = -3
	},
/obj/item/grenade/chem_grenade{
	pixel_y = 4;
	pixel_x = 6
	},
/obj/item/assembly/timer{
	pixel_x = 16;
	pixel_y = -1
	},
/turf/open/indestructible/ground/outside/sidewalk{
	sunlight_state = 0
	},
/area/f13/caves)
"y" = (
/obj/structure/barricade/tentclothedge{
	dir = 4;
	pixel_x = 1
	},
/turf/open/indestructible/ground/inside/mountain,
/area/f13/caves)
"z" = (
/obj/effect/turf_decal/plaque{
	name = "stairs";
	icon = 'icons/obj/stairs.dmi';
	icon_state = "stairs";
	plane = -15;
	layer = 2.14;
	dir = 4;
	color = "#faf0b9";
	pixel_y = 1
	},
/turf/open/indestructible/ground/outside/sidewalk{
	sunlight_state = 0
	},
/area/f13/caves)
"A" = (
/turf/closed/wall/f13/tentwall{
	baseturfs = /turf/open/indestructible/ground/inside/mountain
	},
/area/f13/caves)
"B" = (
/turf/closed/mineral/random/high_chance_prison,
/area/f13/caves)
"C" = (
/obj/effect/decal/cleanable/dirt/dust,
/obj/structure/bookcase,
/obj/item/book/granter/trait/explosives,
/obj/item/book/granter/trait/explosives_advanced,
/turf/open/indestructible/ground/outside/sidewalk{
	sunlight_state = 0
	},
/area/f13/caves)
"D" = (
/obj/structure/closet/crate/miningcar{
	name = "Minecart";
	desc = "A minecart";
	layer = 2.91
	},
/turf/open/indestructible/ground/inside/mountain,
/area/f13/caves)
"F" = (
/obj/item/ammo_casing/caseless/flamethrower,
/obj/effect/decal/cleanable/dirt/dust,
/turf/open/indestructible/ground/outside/sidewalk{
	sunlight_state = 0
	},
/area/f13/caves)
"G" = (
/obj/structure/bed/old{
	icon_state = "bedroll_unrolled";
	plane = 1;
	name = "sleeping bag";
	color = "#4257fc";
	layer = 4;
	pixel_y = 1
	},
/turf/open/indestructible/ground/inside/mountain,
/area/f13/caves)
"H" = (
/obj/structure/barricade/tentclothedge{
	opacity = 0;
	density = 0;
	icon_state = "morecloth_edge";
	layer = 5.01;
	pixel_y = 3
	},
/turf/open/indestructible/ground/inside/mountain,
/area/f13/caves)
"I" = (
/obj/structure/barricade/tentclothcorner{
	dir = 1;
	opacity = 0
	},
/turf/open/indestructible/ground/inside/mountain,
/area/f13/caves)
"J" = (
/obj/item/stack/ore/uranium{
	pixel_y = 1;
	pixel_x = -3
	},
/turf/open/indestructible/ground/inside/mountain,
/area/f13/caves)
"K" = (
/obj/structure/barricade/tentclothcorner,
/turf/open/indestructible/ground/inside/mountain,
/area/f13/caves)
"L" = (
/obj/structure/glowshroom{
	layer = 3
	},
/turf/open/indestructible/ground/inside/mountain,
/area/f13/caves)
"M" = (
/obj/structure/table/round,
/obj/item/reagent_containers/food/drinks/bottle/whiskey{
	name = "Jeddore Premium";
	pixel_y = 7;
	layer = 4.01;
	pixel_x = -2
	},
/turf/open/indestructible/ground/outside/sidewalk{
	sunlight_state = 0
	},
/area/f13/caves)
"N" = (
/obj/structure/simple_door/tent,
/turf/open/indestructible/ground/inside/mountain,
/area/f13/caves)
"O" = (
/obj/item/stack/ore/uranium{
	pixel_y = 1;
	pixel_x = -3
	},
/obj/item/stack/ore/uranium{
	pixel_y = 9;
	pixel_x = -13
	},
/turf/open/indestructible/ground/inside/mountain,
/area/f13/caves)
"P" = (
/turf/closed/indestructible/rock/smoothing,
/area/f13/caves)
"Q" = (
/obj/item/stack/ore/uranium{
	pixel_y = 9;
	pixel_x = -13
	},
/obj/item/stack/ore/uranium,
/turf/open/indestructible/ground/inside/mountain,
/area/f13/caves)
"S" = (
/obj/structure/simple_door/tentflap_cloth{
	pixel_y = -5
	},
/turf/open/indestructible/ground/inside/mountain,
/area/f13/caves)
"T" = (
/obj/structure/barricade/tentclothedge{
	dir = 4;
	opacity = 0;
	pixel_x = 5
	},
/turf/open/indestructible/ground/inside/mountain,
/area/f13/caves)
"U" = (
/obj/structure/bookcase,
/obj/item/paper/hubologyad,
/obj/item/paper/hubologyteachings,
/turf/open/indestructible/ground/outside/sidewalk{
	sunlight_state = 0
	},
/area/f13/caves)
"V" = (
/obj/structure/barricade/tentclothedge{
	dir = 8;
	opacity = 0;
	pixel_x = -5
	},
/turf/open/indestructible/ground/inside/mountain,
/area/f13/caves)
"W" = (
/obj/structure/barricade/tentclothedge{
	dir = 8;
	opacity = 0;
	pixel_x = -4
	},
/turf/open/indestructible/ground/inside/mountain,
/area/f13/caves)
"X" = (
/obj/item/flashlight/lantern{
	on = 1;
	pixel_y = 3;
	layer = 4.29;
	pixel_x = 11
	},
/obj/structure/table/wood/settler,
/obj/item/ammo_casing/caseless/lasermusket{
	pixel_x = -5;
	pixel_y = 4
	},
/turf/open/indestructible/ground/outside/sidewalk{
	sunlight_state = 0
	},
/area/f13/caves)
"Y" = (
/obj/structure/table/wood/settler,
/obj/item/pneumatic_cannon/grenadelauncher,
/obj/item/gavelhammer,
/obj/machinery/light{
	dir = 1
	},
/turf/open/indestructible/ground/outside/sidewalk{
	sunlight_state = 0
	},
/area/f13/caves)

(1,1,1) = {"
a
a
a
a
a
a
a
a
a
a
a
a
"}
(2,1,1) = {"
a
a
a
a
a
a
a
a
a
a
a
a
"}
(3,1,1) = {"
a
a
a
a
a
a
a
a
a
a
a
a
"}
(4,1,1) = {"
a
a
a
a
a
a
a
a
a
a
a
a
"}
(5,1,1) = {"
a
a
a
a
a
a
a
a
a
a
a
a
"}
(6,1,1) = {"
a
a
B
B
B
B
B
B
B
B
a
a
"}
(7,1,1) = {"
a
B
B
B
B
B
B
B
B
B
B
a
"}
(8,1,1) = {"
B
B
B
B
B
B
B
B
B
B
B
a
"}
(9,1,1) = {"
B
B
B
B
B
B
B
B
B
B
B
a
"}
(10,1,1) = {"
B
B
B
B
B
B
B
B
B
a
a
a
"}
(11,1,1) = {"
B
B
B
J
D
B
B
B
B
a
a
a
"}
(12,1,1) = {"
B
B
d
t
l
B
B
B
a
a
a
a
"}
(13,1,1) = {"
B
L
Q
O
B
B
B
a
a
a
a
a
"}
(14,1,1) = {"
B
d
d
B
B
B
a
a
a
a
a
a
"}
(15,1,1) = {"
B
d
d
B
B
a
a
j
T
q
f
a
"}
(16,1,1) = {"
a
d
d
a
a
a
I
y
u
p
H
a
"}
(17,1,1) = {"
a
d
d
d
d
d
S
d
d
o
H
a
"}
(18,1,1) = {"
a
L
d
d
d
d
g
w
d
G
H
a
"}
(19,1,1) = {"
a
a
d
d
L
a
a
m
V
W
K
a
"}
(20,1,1) = {"
h
h
A
N
A
h
h
a
a
a
a
a
"}
(21,1,1) = {"
h
x
v
v
r
C
h
P
P
a
a
a
"}
(22,1,1) = {"
h
c
F
k
M
U
h
P
P
P
a
a
"}
(23,1,1) = {"
h
Y
k
k
v
v
h
P
P
P
a
a
"}
(24,1,1) = {"
h
i
k
k
k
z
h
P
P
a
a
a
"}
(25,1,1) = {"
h
e
k
X
s
s
h
a
a
a
a
a
"}
(26,1,1) = {"
h
h
h
h
h
s
s
a
a
a
a
a
"}
