//MAP CONVERTED BY dmm2tgm.py THIS HEADER COMMENT PREVENTS RECONVERSION, DO NOT REMOVE
"a" = (
/turf/closed/mineral/random/low_chance_prison,
/area/f13/caves)
"r" = (
/turf/closed/indestructible/rock,
/area/f13/caves)
"z" = (
/turf/closed/mineral/random/high_chance_prison,
/area/f13/caves)

(1,1,1) = {"
a
z
z
a
r
a
a
a
a
"}
(2,1,1) = {"
a
a
z
r
r
r
a
a
a
"}
(3,1,1) = {"
a
a
r
r
r
z
z
a
a
"}
(4,1,1) = {"
a
r
r
r
a
a
z
z
z
"}
(5,1,1) = {"
r
r
r
a
a
a
a
a
a
"}
(6,1,1) = {"
a
a
z
z
z
a
a
a
a
"}
(7,1,1) = {"
a
a
z
z
z
z
z
z
a
"}
(8,1,1) = {"
a
a
a
a
z
z
a
a
a
"}
(9,1,1) = {"
a
a
a
a
a
a
z
a
a
"}
(10,1,1) = {"
a
a
a
a
a
a
z
a
a
"}
(11,1,1) = {"
a
a
a
a
a
a
a
a
a
"}
(12,1,1) = {"
a
a
a
a
z
a
a
a
a
"}
(13,1,1) = {"
a
a
a
a
a
a
a
a
a
"}
(14,1,1) = {"
a
a
a
a
a
a
a
a
a
"}
(15,1,1) = {"
a
a
a
a
a
a
a
a
a
"}
(16,1,1) = {"
a
a
a
a
a
a
a
a
a
"}
(17,1,1) = {"
a
a
a
a
a
r
r
r
a
"}
(18,1,1) = {"
a
a
a
a
z
r
r
a
a
"}
(19,1,1) = {"
a
a
a
a
r
r
a
a
a
"}
(20,1,1) = {"
a
a
a
a
r
a
a
a
a
"}
(21,1,1) = {"
a
a
a
r
r
a
a
a
a
"}
(22,1,1) = {"
a
a
a
r
a
z
z
a
a
"}
(23,1,1) = {"
a
a
a
z
z
z
a
a
a
"}
(24,1,1) = {"
a
a
a
z
a
a
a
a
a
"}
(25,1,1) = {"
a
a
a
z
a
a
a
a
a
"}
(26,1,1) = {"
a
a
a
a
a
a
a
a
a
"}
(27,1,1) = {"
a
a
a
a
a
a
a
a
a
"}
(28,1,1) = {"
a
a
r
r
a
a
a
a
a
"}
(29,1,1) = {"
a
a
r
r
r
a
a
r
r
"}
(30,1,1) = {"
a
a
a
r
r
r
r
r
r
"}
(31,1,1) = {"
r
r
r
r
r
r
r
r
a
"}
(32,1,1) = {"
r
r
r
r
a
r
r
a
a
"}
(33,1,1) = {"
r
a
a
a
a
a
r
r
a
"}
(34,1,1) = {"
a
a
a
a
a
a
a
a
a
"}
