//MAP CONVERTED BY dmm2tgm.py THIS HEADER COMMENT PREVENTS RECONVERSION, DO NOT REMOVE
"a" = (
/turf/closed/mineral/random/low_chance_prison,
/area/f13/caves)
"f" = (
/turf/closed/indestructible/rock/smoothing,
/area/f13/caves)
"A" = (
/turf/closed/mineral/random/high_chance_prison,
/area/f13/caves)

(1,1,1) = {"
a
a
a
a
a
a
a
a
a
a
a
a
a
"}
(2,1,1) = {"
a
a
a
a
a
a
a
a
a
a
a
a
a
"}
(3,1,1) = {"
a
a
A
A
A
A
A
a
a
a
a
a
a
"}
(4,1,1) = {"
a
a
A
A
A
A
A
A
a
a
a
a
a
"}
(5,1,1) = {"
a
a
f
f
f
f
f
A
a
a
a
a
a
"}
(6,1,1) = {"
a
f
f
f
f
f
A
A
a
a
a
a
a
"}
(7,1,1) = {"
a
a
f
f
f
a
a
a
a
a
a
a
a
"}
(8,1,1) = {"
a
a
A
A
A
a
a
a
a
a
A
A
a
"}
(9,1,1) = {"
a
a
a
A
A
a
a
a
a
a
A
a
a
"}
(10,1,1) = {"
a
a
a
A
a
A
A
a
a
a
A
a
a
"}
(11,1,1) = {"
a
a
a
a
A
A
A
A
A
a
A
a
a
"}
(12,1,1) = {"
a
a
a
A
A
A
A
a
A
a
a
A
a
"}
(13,1,1) = {"
a
a
a
a
A
a
a
a
A
A
A
A
a
"}
(14,1,1) = {"
a
A
A
A
A
A
A
A
f
f
f
f
a
"}
(15,1,1) = {"
a
a
A
A
A
a
A
f
f
f
f
f
a
"}
(16,1,1) = {"
a
a
a
a
A
A
A
f
f
f
f
a
a
"}
