//MAP CONVERTED BY dmm2tgm.py THIS HEADER COMMENT PREVENTS RECONVERSION, DO NOT REMOVE
"a" = (
/turf/closed/mineral/random/low_chance_prison,
/area/f13/caves)
"m" = (
/turf/closed/mineral/random/high_chance_prison,
/area/f13/caves)
"X" = (
/turf/closed/indestructible/rock/smoothing,
/area/f13/caves)

(1,1,1) = {"
a
a
a
a
a
a
a
a
a
a
a
a
a
"}
(2,1,1) = {"
a
a
a
m
m
m
a
a
a
a
a
a
a
"}
(3,1,1) = {"
a
a
m
m
m
m
a
a
a
a
a
a
a
"}
(4,1,1) = {"
a
X
X
X
m
m
m
a
a
m
m
a
a
"}
(5,1,1) = {"
a
X
X
m
m
m
a
m
a
m
a
a
a
"}
(6,1,1) = {"
a
m
m
m
a
a
a
m
a
a
a
a
a
"}
(7,1,1) = {"
a
a
a
a
a
m
m
m
m
m
a
a
a
"}
(8,1,1) = {"
a
a
a
a
a
m
X
X
X
m
a
a
a
"}
(9,1,1) = {"
a
a
a
a
a
a
X
X
X
m
a
a
a
"}
(10,1,1) = {"
a
a
a
a
a
X
X
X
m
a
a
a
a
"}
(11,1,1) = {"
a
a
a
a
a
a
X
X
m
a
a
a
a
"}
(12,1,1) = {"
a
a
a
a
a
a
m
m
a
a
a
a
a
"}
(13,1,1) = {"
a
a
a
a
a
a
a
m
m
a
a
a
a
"}
(14,1,1) = {"
a
a
a
a
a
a
a
a
m
a
a
a
a
"}
(15,1,1) = {"
a
m
m
m
m
m
m
m
a
a
a
a
a
"}
(16,1,1) = {"
a
a
a
a
a
a
a
a
a
a
a
a
a
"}
