//MAP CONVERTED BY dmm2tgm.py THIS HEADER COMMENT PREVENTS RECONVERSION, DO NOT REMOVE
"a" = (
/turf/closed/mineral/random/low_chance_prison,
/area/f13/caves)
"s" = (
/turf/closed/indestructible/rock,
/area/f13/caves)
"L" = (
/turf/closed/mineral/random/high_chance_prison,
/area/f13/caves)

(1,1,1) = {"
L
L
L
a
a
a
a
a
a
a
a
a
a
a
"}
(2,1,1) = {"
L
L
a
a
a
a
a
a
a
a
a
a
a
a
"}
(3,1,1) = {"
a
a
a
a
a
a
a
a
a
a
a
a
L
a
"}
(4,1,1) = {"
a
a
a
a
a
a
a
a
a
a
a
a
L
a
"}
(5,1,1) = {"
a
a
a
a
a
a
a
s
s
a
a
a
a
a
"}
(6,1,1) = {"
a
a
a
a
a
L
s
s
s
s
a
a
a
a
"}
(7,1,1) = {"
a
a
a
a
a
L
s
s
s
s
s
a
a
a
"}
(8,1,1) = {"
a
a
s
s
s
L
L
a
s
s
s
s
a
a
"}
(9,1,1) = {"
a
s
s
s
s
L
L
a
a
s
s
s
a
a
"}
(10,1,1) = {"
a
s
s
s
a
a
a
a
a
s
a
a
a
a
"}
(11,1,1) = {"
a
s
s
a
a
a
L
a
a
s
s
a
a
a
"}
(12,1,1) = {"
a
a
a
a
a
a
L
a
a
a
s
s
a
a
"}
(13,1,1) = {"
a
a
a
a
a
L
L
a
a
a
a
a
a
a
"}
(14,1,1) = {"
a
a
a
a
a
L
L
a
a
a
a
a
a
a
"}
(15,1,1) = {"
a
a
a
a
L
L
a
a
a
a
a
a
a
a
"}
(16,1,1) = {"
a
a
a
a
L
a
a
a
a
a
a
L
a
a
"}
(17,1,1) = {"
a
a
a
L
a
a
a
a
a
a
a
a
L
a
"}
(18,1,1) = {"
a
a
a
a
a
a
a
a
a
a
a
a
L
a
"}
(19,1,1) = {"
a
a
a
a
a
a
a
a
a
a
a
a
a
L
"}
(20,1,1) = {"
a
a
a
a
a
a
a
a
a
s
s
a
a
a
"}
(21,1,1) = {"
a
a
a
a
a
a
a
a
s
s
s
a
a
a
"}
(22,1,1) = {"
a
a
a
a
a
L
a
s
s
a
a
a
a
a
"}
(23,1,1) = {"
a
a
a
a
L
L
a
s
s
a
a
a
a
a
"}
(24,1,1) = {"
a
a
L
L
a
a
a
a
s
s
a
a
a
a
"}
(25,1,1) = {"
a
a
L
a
a
L
L
L
s
s
a
a
a
a
"}
(26,1,1) = {"
a
a
a
a
a
a
L
L
L
a
a
a
a
a
"}
(27,1,1) = {"
a
a
a
a
a
s
L
L
L
L
a
a
a
a
"}
(28,1,1) = {"
a
a
a
a
s
s
s
L
L
a
a
a
a
a
"}
(29,1,1) = {"
a
s
s
a
a
s
s
s
a
a
a
a
a
a
"}
(30,1,1) = {"
s
s
s
s
s
s
s
s
s
a
a
a
a
a
"}
(31,1,1) = {"
s
s
s
s
s
L
s
s
a
a
a
a
a
a
"}
(32,1,1) = {"
a
s
s
s
s
L
L
s
a
a
a
a
a
a
"}
(33,1,1) = {"
a
a
s
s
s
s
L
L
L
a
a
a
a
L
"}
(34,1,1) = {"
a
a
a
s
s
s
L
L
a
a
a
L
L
a
"}
